ID	文本
TextMapData_TextMapContent_FightPropType	戰鬥屬性範例
TextMapData_TextMapContent_FIGHT_PROP_BASE_HP	生命值
TextMapData_TextMapContent_FIGHT_PROP_HP	生命值
TextMapData_TextMapContent_FIGHT_PROP_HP_PERCENT	生命值加成
TextMapData_TextMapContent_FIGHT_PROP_BASE_ATTACK	攻擊力
TextMapData_TextMapContent_FIGHT_PROP_ATTACK	攻擊力
TextMapData_TextMapContent_FIGHT_PROP_ATTACK_PERCENT	攻擊力加成
TextMapData_TextMapContent_FIGHT_PROP_BASE_DEFENSE	防禦力
TextMapData_TextMapContent_FIGHT_PROP_DEFENSE	防禦力
TextMapData_TextMapContent_FIGHT_PROP_DEFENSE_PERCENT	防禦力加成
TextMapData_TextMapContent_FIGHT_PROP_BASE_SPEED	移動速度
TextMapData_TextMapContent_FIGHT_PROP_SPEED_PERCENT	移動速度
TextMapData_TextMapContent_FIGHT_PROP_CRITICAL	暴擊率
TextMapData_TextMapContent_FIGHT_PROP_ANTI_CRITICAL	暴擊抗性
TextMapData_TextMapContent_FIGHT_PROP_CRITICAL_HURT	暴擊傷害
TextMapData_TextMapContent_FIGHT_PROP_CHARGE_EFFICIENCY	元素充能效率
TextMapData_TextMapContent_FIGHT_PROP_ADD_HURT	傷害增加
TextMapData_TextMapContent_FIGHT_PROP_SUB_HURT	受傷減免
TextMapData_TextMapContent_FIGHT_PROP_HEAL_ADD	治療加成
TextMapData_TextMapContent_FIGHT_PROP_HEALED_ADD	受治療加成
TextMapData_TextMapContent_FIGHT_PROP_FIRE_ADD_HURT	火元素傷害加成
TextMapData_TextMapContent_FIGHT_PROP_FIRE_SUB_HURT	火元素抗性
TextMapData_TextMapContent_FIGHT_PROP_WATER_ADD_HURT	水元素傷害加成
TextMapData_TextMapContent_FIGHT_PROP_WATER_SUB_HURT	水元素抗性
TextMapData_TextMapContent_FIGHT_PROP_GRASS_ADD_HURT	草元素傷害加成
TextMapData_TextMapContent_FIGHT_PROP_GRASS_SUB_HURT	草元素抗性
TextMapData_TextMapContent_FIGHT_PROP_ELEC_ADD_HURT	雷元素傷害加成
TextMapData_TextMapContent_FIGHT_PROP_ELEC_SUB_HURT	雷元素抗性
TextMapData_TextMapContent_FIGHT_PROP_ICE_ADD_HURT	冰元素傷害加成
TextMapData_TextMapContent_FIGHT_PROP_ICE_SUB_HURT	冰元素抗性
TextMapData_TextMapContent_FIGHT_PROP_WIND_ADD_HURT	風元素傷害加成
TextMapData_TextMapContent_FIGHT_PROP_WIND_SUB_HURT	風元素抗性
TextMapData_TextMapContent_FIGHT_PROP_ROCK_ADD_HURT	岩元素傷害加成
TextMapData_TextMapContent_FIGHT_PROP_ROCK_SUB_HURT	岩元素抗性
TextMapData_TextMapContent_FIGHT_PROP_EFFECT_HIT	效果命中
TextMapData_TextMapContent_FIGHT_PROP_EFFECT_RESIST	效果抵抗
TextMapData_TextMapContent_FIGHT_PROP_FREEZE_SHORTEN	凍結時間縮短
TextMapData_TextMapContent_FIGHT_PROP_TORPOR_SHORTEN	麻痹時間縮短
TextMapData_TextMapContent_FIGHT_PROP_DIZZY_SHORTEN	暈眩時間縮短
TextMapData_TextMapContent_FIGHT_PROP_MAX_HP	生命值上限
TextMapData_TextMapContent_FIGHT_PROP_CUR_ATTACK	攻擊力
TextMapData_TextMapContent_FIGHT_PROP_CUR_DEFENSE	防禦力
TextMapData_TextMapContent_FIGHT_PROP_CUR_SPEED	移動速度
TextMapData_TextMapContent_FIGHT_PROP_CUR_HP	生命值
TextMapData_TextMapContent_PROP_MAX_STAMINA	體力上限
TextMapData_TextMapContent_PROP_TEAM_COST	Cost
TextMapData_TextMapContent_FIGHT_REACTION_BURNING	燃燒
TextMapData_TextMapContent_FIGHT_REACTION_WET	潮濕
TextMapData_TextMapContent_FIGHT_REACTION_STEAM	蒸發
TextMapData_TextMapContent_FIGHT_REACTION_GRASS	生長
TextMapData_TextMapContent_FIGHT_REACTION_SHOCK	感電
TextMapData_TextMapContent_FIGHT_REACTION_FROZEN	凍結
TextMapData_TextMapContent_FIGHT_REACTION_EXPLODE	超載
TextMapData_TextMapContent_FIGHT_REACTION_MELT	融化
TextMapData_TextMapContent_FIGHT_REACTION_SWIRL	擴散
TextMapData_TextMapContent_FIGHT_REACTION_SUPERCONDUCTOR	超導
TextMapData_TextMapContent_EquipType	裝備類型範例
TextMapData_TextMapContent_EQUIP_BRACER	生之花
TextMapData_TextMapContent_EQUIP_DRESS	理之冠
TextMapData_TextMapContent_EQUIP_SHOES	時之沙
TextMapData_TextMapContent_EQUIP_RING	空之杯
TextMapData_TextMapContent_EQUIP_NECKLACE	死之羽
TextMapData_TextMapContent_Topic_LvUp	角色升級了
TextMapData_TextMapContent_Hint_CanNotTakeOffWeapon	無法卸下武器
TextMapData_TextMapContent_Hint_NotEnoughLevel	等級不足
TextMapData_TextMapContent_INFO_DANGER_AROUND	附近還有危險！
TextMapData_TextMapContent_INFO_TRANSPOINT_GET	傳送錨點解鎖
TextMapData_TextMapContent_INFO_DUNGEON_WAY_POINT_GET	與復甦之門已建立聯繫
TextMapData_TextMapContent_INFO_AVATAR_DIE	角色無法戰鬥
TextMapData_TextMapContent_INFO_AVATAR_CHANGE_CD	換人還在CD中
TextMapData_TextMapContent_INFO_AVATAR_CHANGE_LEVEL_FORBIDDEN	目標異常
TextMapData_TextMapContent_INFO_AVATAR_CHANGE_IN_PROCESS	角色釋放技能中
TextMapData_TextMapContent_INFO_AVATAR_CHANGE_FAIL_AIM	瞄準時不可換人
TextMapData_TextMapContent_INFO_AVATAR_CHANGE_FAIL_CLIMB	攀爬時不能切換角色
TextMapData_TextMapContent_INFO_AVATAR_CHANGE_FAIL_FLY	飛行時不能切換角色
TextMapData_TextMapContent_INFO_AVATAR_CHANGE_FAIL_JUMP	跳躍時不能切換角色
TextMapData_TextMapContent_INFO_AVATAR_CHANGE_FAIL_LADDER	攀爬時不能切換角色
TextMapData_TextMapContent_INFO_AVATAR_CHANGE_FAIL_SWIM	游泳時不能切換角色
TextMapData_TextMapContent_INFO_AVATAR_CHANGE_FAIL_DEAD	倒下時不能切換角色
TextMapData_TextMapContent_INFO_AVATAR_CHANGE_FAIL_PERFORM	坐下時不能切換角色
TextMapData_TextMapContent_INFO_AVATAR_CHANGE_LEVEL_TARGETAVATAR	無法切換目標角色
TextMapData_TextMapContent_INFO_PLAYER_RECONNECT	重新連接伺服器
TextMapData_TextMapContent_INFO_PLAYER_QUIE_MULTIPLAYER	退出連線
TextMapData_TextMapContent_INFO_AVATAR_TRANSPORT_DUNGEON_TITLE	退出地城
TextMapData_TextMapContent_INFO_AVATAR_TRANSPORT_DUNGEON_DESC	<size=36>現在傳送將退出地城，是否繼續？</size>\n\n<size=24>未撿拾物品將丟失，暫時無法尋回</size>
TextMapData_TextMapContent_INFO_AVATAR_TRANSPORT_DUNGEON_CANCEL	返回地城
TextMapData_TextMapContent_INFO_AVATAR_TRANSPORT_DUNGEON_OK	繼續傳送
TextMapData_TextMapContent_INFO_CAN_NOT_USE_TRANSPOINT	蒙德城被封鎖，目前無法傳送
TextMapData_TextMapContent_INFO_TRANSPOINT_NOT_UNLOCKED	尚未解鎖
TextMapData_TextMapContent_INFO_AREA_LEVEL_TOO_HIGH	高危險度
TextMapData_TextMapContent_INFO_GET_TRIAL_AVATAR	
TextMapData_TextMapContent_INFO_PLAYER_EXP_ADD	<color=#37FFFFFF>冒險閱歷 +{0}</color>
TextMapData_TextMapContent_INFO_PLAYER_LEVEL_ADD	冒險等階提升至{0}
TextMapData_TextMapContent_INFO_MALE_PRONOUN_HE	他
TextMapData_TextMapContent_INFO_FEMALE_PRONOUN_SHE	她
TextMapData_TextMapContent_INFO_MALE_PRONOUN_BROTHER	哥哥
TextMapData_TextMapContent_INFO_FEMALE_PRONOUN_SISTER	妹妹
TextMapData_TextMapContent_INFO_MALE_PRONOUN_BOY	少年
TextMapData_TextMapContent_INFO_FEMALE_PRONOUN_GIRL	少女
TextMapData_TextMapContent_INFO_PLAYER_DEFAULT_NAME	
TextMapData_TextMapContent_INFO_CHANGE_AVATAR_COST_OVER	所換角色Cost超過隊伍消耗上限，可嘗試更換其他角色
TextMapData_TextMapContent_INFO_CHANGE_WEAPON_COST_OVER	所換武器Cost超過隊伍消耗上限，可嘗試更換其他武器
TextMapData_TextMapContent_INFO_WEAPON_BREAK_COST_OVER	武器突破後Cost將超出隊伍消耗上限，可嘗試取下後進行突破
TextMapData_TextMapContent_INFO_SUPPORT_SECOND	追加援助：
TextMapData_TextMapContent_INFO_ITEM_NOT_EXIST	物品不存在
TextMapData_TextMapContent_INFO_ITEM_NOT_INTERACT	物品不能互動
TextMapData_TextMapContent_INFO_ITEM_NOT_GATHER	物品不能採集
TextMapData_TextMapContent_INFO_ITEM_ONLY_USEABLE_FOR_ALIVE_AVATAR	物品無法對倒下的角色使用
TextMapData_TextMapContent_INFO_ITEM_ONLY_USEABLE_FOR_DEAD_AVATAR	物品只能對倒下的角色使用
TextMapData_TextMapContent_INFO_BAG_FULL	背包已滿
TextMapData_TextMapContent_INFO_INTERACTION_FAIL_FOCUS	瞄準狀態下無法對話
TextMapData_TextMapContent_INFO_ELITE_DEFENCE	
TextMapData_TextMapContent_INFO_NOTICE_ADD_HP	生命值已滿，是否繼續使用？
TextMapData_TextMapContent_SHOP_EXCHANGE_BUTTON	兌換
TextMapData_TextMapContent_SHOP_LIMITED_PURCHASE	剩餘數量：{0}
TextMapData_TextMapContent_SHOP_SOLD_OUT	<color=#FF5E41FF>已售罄</color>
TextMapData_TextMapContent_SHOP_FRESH_TIME	刷新時間：{0}
TextMapData_TextMapContent_BAG_DROP_BUTTON	丟棄
TextMapData_TextMapContent_BAG_USE_BUTTON	使用
TextMapData_TextMapContent_BAG_DETAIL_BUTTON	詳情
TextMapData_TextMapContent_ITEM_CONSUME	消耗品
TextMapData_TextMapContent_ITEM_FOOD	食物
TextMapData_TextMapContent_ITEM_QUEST	任務
TextMapData_TextMapContent_ITEM_EQUIP	聖遺物
TextMapData_TextMapContent_ITEM_MATERIAL	材料
TextMapData_TextMapContent_ITEM_EXP_FRUIT	材料
TextMapData_TextMapContent_ITEM_WEAPON	武器
TextMapData_TextMapContent_ITEM_AVATAR	角色
TextMapData_TextMapContent_QUEST_NEW	新任務
TextMapData_TextMapContent_QUEST_REPLACE	任務變更
TextMapData_TextMapContent_QUEST_COMPLETE	任務完成
TextMapData_TextMapContent_QUEST_FAIL	任務失敗
TextMapData_TextMapContent_QUEST_REMIND	任務提示
TextMapData_TextMapContent_Player_Default_Name	旅行者
TextMapData_TextMapContent_ElementType	元素類型範例
TextMapData_TextMapContent_None	無
TextMapData_TextMapContent_Fire	火元素
TextMapData_TextMapContent_Water	水元素
TextMapData_TextMapContent_Grass	草元素
TextMapData_TextMapContent_Electric	雷元素
TextMapData_TextMapContent_Wind	風元素
TextMapData_TextMapContent_Ice	冰元素
TextMapData_TextMapContent_Rock	岩元素
TextMapData_TextMapContent_TIP_SKIP_CUTSCENE	是否跳過？
TextMapData_TextMapContent_DUNGEON_PLOT	劇情
TextMapData_TextMapContent_DUNGEON_FIGHT	戰鬥
TextMapData_TextMapContent_DUNGEON_SUCCESS	挑戰成功
TextMapData_TextMapContent_DUNGEON_LOSE	挑戰失敗
TextMapData_TextMapContent_DUNGEON_TIMELIMIT	已達地城最大進入次數
TextMapData_TextMapContent_TIP_CHANGE_TIME_TOO_SHORT	時間少於{0}分鐘
TextMapData_TextMapContent_PlayerDieType	失敗類型
TextMapData_TextMapContent_PlayerDieNone	全部隊員已倒下
TextMapData_TextMapContent_PlayerDieKillByMonster	注意敵人
TextMapData_TextMapContent_PlayerDieKillByGear	小心機關
TextMapData_TextMapContent_PlayerDieFall	墜落
TextMapData_TextMapContent_PlayerDieDrawn	溺水
TextMapData_TextMapContent_PlayerDieAbyss	墜入深淵
TextMapData_TextMapContent_SettleShowType	地下城結算顯示條目類型
TextMapData_TextMapContent_SETTLE_SHOW_NONE	未定義
TextMapData_TextMapContent_SETTLE_SHOW_TIME_COST	通關時間：
TextMapData_TextMapContent_SETTLE_SHOW_OPEN_CHEST_COUNT	秘密寶箱獲得：
TextMapData_TextMapContent_SETTLE_SHOW_KILL_MONSTER_COUNT	殺死怪物：
TextMapData_TextMapContent_INFO_AREA_EXPLORE_UPDATED	{0}探索度增加
TextMapData_TextMapContent_INFO_DUNGEON_SETTLED_LEAVE_AFTER	{0}秒後退出
TextMapData_TextMapContent_WeaponType	武器類型範例
TextMapData_TextMapContent_WEAPON_NONE	未知武器
TextMapData_TextMapContent_WEAPON_SWORD_ONE_HAND	單手劍
TextMapData_TextMapContent_WEAPON_CROSSBOW	弩
TextMapData_TextMapContent_WEAPON_STAFF	法杖
TextMapData_TextMapContent_WEAPON_DOUBLE_DAGGER	雙短刀
TextMapData_TextMapContent_WEAPON_KATANA	太刀
TextMapData_TextMapContent_WEAPON_SHURIKEN	手裡劍
TextMapData_TextMapContent_WEAPON_STICK	棍
TextMapData_TextMapContent_WEAPON_SPEAR	長柄
TextMapData_TextMapContent_WEAPON_SHIELD_SMALL	小盾
TextMapData_TextMapContent_WEAPON_CATALYST	法器
TextMapData_TextMapContent_WEAPON_CLAYMORE	雙手劍
TextMapData_TextMapContent_WEAPON_BOW	弓
TextMapData_TextMapContent_WEAPON_POLE	長柄
TextMapData_TextMapContent_INFO_TEAM_CHANGE_AVATAR	無法操作正在使用的角色
TextMapData_TextMapContent_INFO_TEAM_CLOSE_TIP	是否確認退出當前介面？
TextMapData_TextMapContent_INFO_TEAM_OPEN_TIP	獲得新角色，是否打開隊伍介面查看新角色？
TextMapData_TextMapContent_INFO_TEAM_CANT_OPEN_TIP	當前狀態不可打開隊伍介面
TextMapData_TextMapContent_INFO_TEAM_LEADER_SKILL_DISABLE	未啟動
TextMapData_TextMapContent_INFO_TEAM_LEADER_SKILL_TITLE	隊長技：
TextMapData_TextMapContent_INFO_TEAM_LEADER_SKILL_NONE	暫無
TextMapData_TextMapContent_INFO_TEAM_LEADER_SKILL_TIP	請選擇持有隊長技的角色啟動隊長技
TextMapData_TextMapContent_INFO_TEAM_NEED_ALIVE_CHARACTER	其他隊友已倒下，隊伍中至少保留一個可行動的角色
TextMapData_TextMapContent_INFO_TEAM_NEED_ONE_CHARACTER	隊伍中至少保留一名角色
TextMapData_TextMapContent_EQUIP_NO_SLOT_TO_ADD	當前無空位放入
TextMapData_TextMapContent_EQUIP_WEAPON_LEVEL_OVER_TIP	所選武器等級較高，是否繼續？
TextMapData_TextMapContent_EQUIP_WEAPON_BREAK_OVER_TIP	所選武器突破等級較高，是否繼續？
TextMapData_TextMapContent_EQUIP_WEAPON_QUALITY_OVER_TIP	所選武器品質較高，是否繼續？
TextMapData_TextMapContent_EQUIP_WEAPON_LEVEL_MAX_TO_BREAK	已達到當前等級上限，請前往突破頁面
TextMapData_TextMapContent_EQUIP_WEAPON_LEVEL_MAX	已達到當前等級上限
TextMapData_TextMapContent_EQUIP_WEAPON_LEVEL_NOT_ENOUGH	武器等級不足，不能突破
TextMapData_TextMapContent_EQUIP_WEAPON_BREAK_LEVEL_MAX	已達到當前突破等級上限
TextMapData_TextMapContent_EQUIP_WEAPON_BREAK_NEED	請點選放入{0}個突破等級為{1}的武器才可突破
TextMapData_TextMapContent_EQUIP_WEAPON_AWAKEN_LEVEL_MAX	已達到當前精煉等級上限
TextMapData_TextMapContent_EQUIP_WEAPON_LEVELUP_EXP_OVERFLOW	本次強化經驗溢出{0}點（不退還），是否繼續？
TextMapData_TextMapContent_EQUIP_RELIC_BREAK_OVER_TIP	所選聖遺物突破等級較高，是否繼續？
TextMapData_TextMapContent_EQUIP_RELIC_SUBQUALITY_OVER_TIP	所選聖遺物副屬性較高，是否繼續？
TextMapData_TextMapContent_EQUIP_RELIC_SET_NAME	{0}：
TextMapData_TextMapContent_EQUIP_RELIC_SET_NUM	{0}件套：
TextMapData_TextMapContent_EQUIP_RELIC_LEVEL_NOT_ENOUGH	武器等級不足，不能突破
TextMapData_TextMapContent_EQUIP_RELIC_BREAK_PROP_ADD	突破可增加一條新的追加屬性
TextMapData_TextMapContent_EQUIP_RELIC_BREAK_PROP_IMPROVE	突破可隨機提升任一追加屬性
TextMapData_TextMapContent_EQUIP_RELIC_BREAK_MATERIAL_NOT_ENOUGH	{0}不足
TextMapData_TextMapContent_EQUIP_MAX_EXP_TIP	已達到最大經驗，無法添加
TextMapData_TextMapContent_EQUIP_NO_FOOD_TIP	請選擇升級材料
TextMapData_TextMapContent_EQUIP_LEVEL	Lv.{0}
TextMapData_TextMapContent_EQUIP_LEVEL_WITH_MAX	Lv.{0}<color=#FFFFFF9B> / {1}</color>
TextMapData_TextMapContent_EQUIP_SCREEN	篩選
TextMapData_TextMapContent_EQUIP_SCREEN_WITH_NAME	篩選 / {0}
TextMapData_TextMapContent_EQUIP_SCREEN_ALL	全部
TextMapData_TextMapContent_EQUIP_LEVELUP_SUCCESS	成功
TextMapData_TextMapContent_EQUIP_LEVELUP_SUPER_SUCCESS	兩倍經驗強化
TextMapData_TextMapContent_EQUIP_LEVELUP_SUPER_GREAT_SUCCESS	五倍經驗強化！
TextMapData_TextMapContent_EQUIP_LEVELUP_SUCCESS_TIP	+{0}（×{1}）倍暴擊強化！
TextMapData_TextMapContent_EQUIP_FAST_ADD_OVER_TIP	添加的材料中存在強力裝備
TextMapData_TextMapContent_EQUIP_REPLACE_TIP	{0}已被{1}裝備，是否更換？
TextMapData_TextMapContent_EQUIP_FAST_ADD_NO_FOOD_TIP	沒有可用於消耗的物品
TextMapData_TextMapContent_EQUIP_AWAKEN_COUNT_USED_TIP	精煉提升次數 <color=#99FF88FF>{0}</color> / {1}
TextMapData_TextMapContent_EQUIP_AWAKEN_COUNT_UNUSE	還有剩餘的精煉次數
TextMapData_TextMapContent_EQUIP_AWAKEN_FOOD_UNSELECT	未選擇精煉材料
TextMapData_TextMapContent_EQUIP_AWAKEN_NEED_NOT_ENOUGH	{0}不足
TextMapData_TextMapContent_SORT_BY_LEVEL	等級順序
TextMapData_TextMapContent_SORT_BY_COST	Cost順序
TextMapData_TextMapContent_SORT_BY_QUALITY	品質順序
TextMapData_TextMapContent_SORT_BY_EXP	基礎經驗順序
TextMapData_TextMapContent_SORT_BY_ELEMENT	元素順序
TextMapData_TextMapContent_INFO_MONSTER_SUPPRESS_STAGE_01	有強大怪物的氣息，請多加注意
TextMapData_TextMapContent_INFO_MONSTER_SUPPRESS_STAGE_02	敵人的氣息愈發兇險，還是返回為妙！
TextMapData_TextMapContent_TALENT_LOCK_COLOR	<color=#808080FF>{0}</color>
TextMapData_TextMapContent_TALENT_UNLOCK_COLOR	<color=#FFFFFFFF>{0}</color>
TextMapData_TextMapContent_TALENT_UNLOCK_NEED	需要{0}達到{1}級
TextMapData_TextMapContent_TALENT_DESCRIPTION	{0}級：{1}
TextMapData_TextMapContent_TALENT_BIG_TYPE	星輝天賦
TextMapData_TextMapContent_TALENT_SMALL_TYPE	星塵天賦
TextMapData_TextMapContent_TALENT_LEVEL_MAX	已經滿級
TextMapData_TextMapContent_TALENT_AVATAR_LEVEL_NOT_ENOUGH	角色等級不夠
TextMapData_TextMapContent_TALENT_AVATAR_BREAK_NOT_ENOUGH	角色突破等級不夠
TextMapData_TextMapContent_TALENT_PRETALENT_UNLOCK	前置{0}沒有啟動
TextMapData_TextMapContent_TALENT_POINT_NOT_ENOUGH	{0}不足
TextMapData_TextMapContent_TALENT_POINT_SMALL_NAME	星塵
TextMapData_TextMapContent_TALENT_POINT_BIG_NAME	星輝
TextMapData_TextMapContent_TALENT_AVATAR_LEVEL_NEED	{0} Lv.{1}
TextMapData_TextMapContent_TALENT_CARD_TO_POINT_TIP	將消耗該道具轉化為<color=#FFFFFF> <size=26>{0}</size> </color>點{1}
TextMapData_TextMapContent_TALENT_CARD_USE_NUM_LIMIT_TIP	已達到角色可使用的星塵/星輝上限
TextMapData_TextMapContent_AVATAR_TALENT_POINT_SMALL_CHANGE	{0}獲得{1}點星塵點
TextMapData_TextMapContent_AVATAR_TALENT_POINT_BIG_CHANGE	{0}獲得{1}點星輝點
TextMapData_TextMapContent_ITEM_NOT_ENOUGH_COLOR	<color=#FF5E41FF>{0}</color>
TextMapData_TextMapContent_ITEM_NEED_OF_CURRENT	{0}/{1}
TextMapData_TextMapContent_INFO_BORED_CREATE_MONSTER	<color=#FF5E41FF>警戒！精英怪物出現！</color>
TextMapData_TextMapContent_INFO_NEW_AVATAR	獲得新角色: {0}
TextMapData_TextMapContent_INFO_NEW_ITEM	獲得: {0}
TextMapData_TextMapContent_INFO_SYSTEM_NO_PATH	當前位置無法尋找到目標
TextMapData_TextMapContent_INFO_AVATAR_PROMOTE_BEYOND_TEAM_COST	角色突破後Cost將超出隊伍消耗上限，可嘗試先離隊再突破
TextMapData_TextMapContent_INFO_AVATAR_PROMOTE_MATERIAL_NOT_ENOUGH	突破材料不夠！
TextMapData_TextMapContent_INFO_NAME_IS_TOO_SHORT	名字不能小於{0}個字
TextMapData_TextMapContent_INFO_NAME_IS_TOO_LONG	名字不能超過{0}個字
TextMapData_TextMapContent_INFO_NAME_HAS_INVALID_CHAR	名字中不能包含{0}
TextMapData_TextMapContent_INFO_NAME_SPACE	空格
TextMapData_TextMapContent_INFO_QUEST_INTERACT_FAIL_FIGHT	戰鬥中無法進行任務對話
TextMapData_TextMapContent_EQUIP_AFFIX_LEVEL0	Lv1
TextMapData_TextMapContent_EQUIP_AFFIX_LEVEL1	Lv2
TextMapData_TextMapContent_EQUIP_AFFIX_LEVEL2	Lv3
TextMapData_TextMapContent_EQUIP_AFFIX_LEVEL3	Lv4
TextMapData_TextMapContent_EQUIP_AFFIX_LEVEL4	Lv5
TextMapData_TextMapContent_INFO_FOOD_BUFF	成功使用{0}，{1}{2}
TextMapData_TextMapContent_INFO_Item_Food_RecoverHP	將在一段時間內恢復生命值
TextMapData_TextMapContent_INFO_Item_Food_RecoverInstantHP	將立即恢復部分生命值
TextMapData_TextMapContent_INFO_Item_Food_Attack	將在一段時間內提升攻擊力
TextMapData_TextMapContent_INFO_Item_Food_MoveSpeed	將在一段時間內提升移動速度
TextMapData_TextMapContent_INFO_Item_Food_Defence	將在一段時間內提升防禦力
TextMapData_TextMapContent_CONTROL_MOVE_FORWARD	向前移動
TextMapData_TextMapContent_CONTROL_MOVE_BACKWARD	向後移動
TextMapData_TextMapContent_CONTROL_MOVE_LEFT	向左移動
TextMapData_TextMapContent_CONTROL_MOVE_RIGHT	向右移動
TextMapData_TextMapContent_CONTROL_SKILL1	普通攻擊
TextMapData_TextMapContent_CONTROL_SKILL2	元素戰技
TextMapData_TextMapContent_CONTROL_SPRINT_OR_SKILL3	衝刺
TextMapData_TextMapContent_CONTROL_JUMP_OR_SKILL4	跳躍
TextMapData_TextMapContent_CONTROL_SKILL5	元素爆發
TextMapData_TextMapContent_CONTROL_OPEN_BAG	打開背包
TextMapData_TextMapContent_CONTROL_OPEN_CHARACTER	打開角色介面
TextMapData_TextMapContent_CONTROL_OPEN_MAP	打開地圖
TextMapData_TextMapContent_CONTROL_OPEN_PAIMEN	打開派蒙介面
TextMapData_TextMapContent_CONTROL_TOGGLE_QUEST_BOOK	開關任務功能表
TextMapData_TextMapContent_CONTROL_TO_AVATAR1	切換小隊角色1
TextMapData_TextMapContent_CONTROL_TO_AVATAR2	切換小隊角色2
TextMapData_TextMapContent_CONTROL_TO_AVATAR3	切換小隊角色3
TextMapData_TextMapContent_CONTROL_TO_AVATAR4	切換小隊角色4
TextMapData_TextMapContent_CONTROL_TO_AVATAR1_TRIGGER_SKILL	切換到小隊角色1並使用其元素爆發
TextMapData_TextMapContent_CONTROL_TO_AVATAR2_TRIGGER_SKILL	切換到小隊角色2並使用其元素爆發
TextMapData_TextMapContent_CONTROL_TO_AVATAR3_TRIGGER_SKILL	切換到小隊角色3並使用其元素爆發
TextMapData_TextMapContent_CONTROL_TO_AVATAR4_TRIGGER_SKILL	切換到小隊角色4並使用其元素爆發
TextMapData_TextMapContent_CONTROL_TOGGLE_ATTACK_MODE	切換瞄準模式
TextMapData_TextMapContent_CONTROL_PICK_TALK	拾取/對話
TextMapData_TextMapContent_CONTROL_MOVE	移動角色
TextMapData_TextMapContent_CONTROL_VIEW	轉動視角
TextMapData_TextMapContent_CONTROL_CHANGE_AVATAR_TRIGGER	叫出換人輪盤
TextMapData_TextMapContent_CONTROL_ELEMENT_VIEW	長按打開元素視野
TextMapData_TextMapContent_CONTROL_HELP	打開提示頁面
TextMapData_TextMapContent_CONTROL_SLOW_MOVE	切換走/跑
TextMapData_TextMapContent_KeyCode_Alpha1	1
TextMapData_TextMapContent_KeyCode_Alpha2	2
TextMapData_TextMapContent_KeyCode_Alpha3	3
TextMapData_TextMapContent_KeyCode_Alpha4	4
TextMapData_TextMapContent_KeyCode_Escape	Esc
TextMapData_TextMapContent_KeyCode_LeftControl	左Ctrl
TextMapData_TextMapContent_KeyCode_LeftAlt	左Alt
TextMapData_TextMapContent_KeyCode_LeftShift	左Shift
TextMapData_TextMapContent_KeyCode_Mouse0	滑鼠左鍵
TextMapData_TextMapContent_KeyCode_Mouse1	滑鼠右鍵
TextMapData_TextMapContent_KeyCode_Mouse2	滑鼠中鍵
TextMapData_TextMapContent_NEW_AVATAR_GET_TIP	獲得 {0}
TextMapData_TextMapContent_EQUIP_RANK_LEVEL1	
TextMapData_TextMapContent_EQUIP_RANK_LEVEL2	
TextMapData_TextMapContent_EQUIP_RANK_LEVEL3	
TextMapData_TextMapContent_EQUIP_RANK_LEVEL4	
TextMapData_TextMapContent_EQUIP_RANK_LEVEL5	
TextMapData_TextMapContent_UI_REPAIR_SKYHARP_PAGE_RESULT_ONE	天空之琴似乎有種青春煥發的感覺
TextMapData_TextMapContent_UI_REPAIR_SKYHARP_PAGE_RESULT_TWO	天空之琴和原先的感覺完全不一樣了，周圍的風元素似乎在躁動
TextMapData_TextMapContent_COOK_COOK	料理製作
TextMapData_TextMapContent_COOK_COMPOUND	食材加工
TextMapData_TextMapContent_COOK_RANDOM_COOK	亂燉
TextMapData_TextMapContent_COOK_FOOD_MEAT	衛士料理
TextMapData_TextMapContent_COOK_FOOD_FRUIT	勇者料理
TextMapData_TextMapContent_COOK_FOOD_STAPLE	冒險家料理
TextMapData_TextMapContent_COOK_FOOD_SWEET	賢者料理
TextMapData_TextMapContent_COOKING_PAGE_HAVE_NUM	已持有：{0}
TextMapData_TextMapContent_COOKING_PAGE_COMPOUND_QUEUE_SIZE	列隊上限：{0}
TextMapData_TextMapContent_COOKING_PAGE_NOT_ENOUGH_TIP	材料不足（有些原料可以去城裡的餐館碰碰運氣哦）
TextMapData_TextMapContent_COOKING_ITEM_PROFICIENCY	熟練度 {0}/{1}
TextMapData_TextMapContent_COOKING_ITEM_COOK_NEED	烹飪材料
TextMapData_TextMapContent_COOKING_ITEM_COMPOUND_NEED	加工原料
TextMapData_TextMapContent_COOKING_ITEM_COMPOUND_TIME	製作耗時 {0:F1} 分鐘
TextMapData_TextMapContent_COOKING_NEED_FIRE	請先點火
TextMapData_TextMapContent_COOKING_QTE_ITEM_QUALITY1	完成
TextMapData_TextMapContent_COOKING_QTE_ITEM_QUALITY2	成功
TextMapData_TextMapContent_COOKING_QTE_ITEM_QUALITY3	完美
TextMapData_TextMapContent_COOKING_QTE_NO_BONUS_DESC	該角色暫無加成
TextMapData_TextMapContent_COOKING_COMPOUND_QUEUE_MAX	列隊已滿
TextMapData_TextMapContent_COOKING_COMPOUND_CURRENT_COUNT	<color=#FFFFFFFF>{0}/{1}</color>
TextMapData_TextMapContent_COOKING_AVATAR_SELECT_CURRENT	{0} <color=#FFCC33FF><size=20>/ 當前</size></color>
TextMapData_TextMapContent_COOK_BONUS_REPLACE	有機率獲得特殊料理
TextMapData_TextMapContent_COOK_BONUS_PROFICIENCY	熟練度獲取加倍
TextMapData_TextMapContent_MAIL_ITEM_NOT_RECEIVE_TIP	附件未領取
TextMapData_TextMapContent_MAIL_CONFIRM_DELETE_TIP	確認刪除？
TextMapData_TextMapContent_MAIL_CONFIRM_DELETE_IMPORTANCE_TIP	有重要信件，確認刪除？
TextMapData_TextMapContent_MAIL_DETAIL_SENDER	寄件者：{0}
TextMapData_TextMapContent_MAIL_DETAIL_DATE	時間：{0}
TextMapData_TextMapContent_MAIL_MAX_NUM_TIP	收件箱最多保存 1000封 信件，\n超出時自動刪除無附件或附件已領取的舊信件
TextMapData_TextMapContent_MAIL_NO_ITEM_GET_ALL_TIP	您的信箱內附件已全部領取完畢
TextMapData_TextMapContent_MAIL_OVER_TIME_SECOND	剛剛
TextMapData_TextMapContent_MAIL_OVER_TIME_MINUTE	{0}分鐘
TextMapData_TextMapContent_MAIL_OVER_TIME_HOUR	{0}小時
TextMapData_TextMapContent_MAIL_OVER_TIME_DAY	{0}天
TextMapData_TextMapContent_MAIL_EXPIRE_TIME_DAY	{0}天後過期
TextMapData_TextMapContent_ITEM_TIP_PLAYER_LEVEL_ITEM	需求冒險等階{0}
TextMapData_TextMapContent_ITEM_TIP_PLAYER_LEVEL_EQUIP	需求冒險等階{0}
TextMapData_TextMapContent_EQUIP_CHANGE_TIP_PLAYER_LEVEL	需求冒險等階{0}
TextMapData_TextMapContent_EQUIP_PLAYER_LEVEL_NOT_ENOUGH_TIP	冒險等階不足，無法裝備
TextMapData_TextMapContent_ITEM_PLAYER_LEVEL_NOT_ENOUGH_TIP	冒險等階不足，無法使用
TextMapData_TextMapContent_ITEM_SLOT_COUNT_DOWN_SECOND	{0}秒
TextMapData_TextMapContent_ITEM_SLOT_COUNT_DOWN_MINUTE	{0}分鐘
TextMapData_TextMapContent_ITEM_SLOT_COUNT_DOWN_HOUR	{0}小時
TextMapData_TextMapContent_ITEM_GOT_DIALOG_REASON_MAIL	信件附件
TextMapData_TextMapContent_FETCH_BUTTON_HINT	已完成{0}個
TextMapData_TextMapContent_COUNT_SELECT_DIALOG_COMPOUND	選擇加工數量
TextMapData_TextMapContent_PLAYER_MAX_STAMINA_CHANGE	體力上限提升{0}→{1}
TextMapData_TextMapContent_OPEN_STATE_AVATAR_PROMOTE	角色突破
TextMapData_TextMapContent_OPEN_STATE_AVATAR_TALENT	角色天賦
TextMapData_TextMapContent_OPEN_STATE_WEAPON_PROMOTE	武器突破
TextMapData_TextMapContent_OPEN_STATE_WEAPON_AWAKEN	武器精煉
TextMapData_TextMapContent_OPEN_STATE_WEAPON_UPGRADE	武器強化
TextMapData_TextMapContent_OPEN_STATE_RELIQUARY_PROMOTE	聖遺物突破
TextMapData_TextMapContent_OPEN_STATE_RELIQUARY_UPGRADE	聖遺物強化
TextMapData_TextMapContent_OPEN_STATE_CHANGE_TIP_OPEN	{0}功能開啟
TextMapData_TextMapContent_OPEN_STATE_CLOSE_TIP	暫未開啟
TextMapData_TextMapContent_OPEN_STATE_CLOSE_TIP_LEVEL	開啟條件：冒險等階{0}級
TextMapData_TextMapContent_OPEN_STATE_CLOSE_TIP_QUEST	開啟條件：完成任務{0}
TextMapData_TextMapContent_PAGE_TITLE_SEPARATOR	{0} /
TextMapData_TextMapContent_COST_TEXT_MAP_VALUE	Cost
TextMapData_TextMapContent_ITEM_NOT_ENOUGH_COMMON_TIP	{0}不足
TextMapData_TextMapContent_PROP_CHANGE_ADD_TIP	{0}增加{1}
TextMapData_TextMapContent_PROP_CHANGE_REDUCE_TIP	{0}減少{1}
TextMapData_TextMapContent_DUNGEON_MUTIPLAYER_HOST_DIALOG_TIP	目前處於連線狀態，進入單人副本需要踢出所有隊員，是否繼續？
TextMapData_TextMapContent_DUNGEON_MUTIPLAYER_HOST_OK_BUTTON	踢出隊員
TextMapData_TextMapContent_DUNGEON_MUTIPLAYER_HOST_CANCEL_BUTTON	放棄進入
TextMapData_TextMapContent_RET_JOIN_OTHER_WAIT	正在準備連線，請等待
TextMapData_TextMapContent_GENERAL_PROMPT_DIALOG_NEW_MAIL_TIP	新的信件
TextMapData_TextMapContent_REWARD_ITEM_GOT_TIP	{0} <color=#FFFFFF80><size=14>×</size></color> {1}
TextMapData_TextMapContent_SHOP_ITEM_REFRESH_FORMAT	yyyy/MM/dd HH:mm
TextMapData_TextMapContent_COMMON_ITEM_COUNT_FORMAT	{0}×{1}
TextMapData_TextMapContent_QUEST_DIALOG_SELECT_PLAYER_LEVEL_NEED	需要冒險等階{0}
TextMapData_TextMapContent_QUEST_DIALOG_DETAIL_PLAYER_LEVEL_NEED	將冒險等階提升至{0}開啟
TextMapData_TextMapContent_CHAPTER_COMPLETE_DIALOG_TITLE	{0} 完成
TextMapData_TextMapContent_CHAPTER_NOTICE_DIALOG_TITLE	{0} {1}\n在<color=#FFFFFFFF>冒險等階{2}</color>後開啟
TextMapData_TextMapContent_LOADING_DIALOG_TIPS	本次測試為第一次刪檔測試，不代表遊戲最終品質
TextMapData_TextMapContent_LANGUAGE_NAME_SC	简体中文
TextMapData_TextMapContent_LANGUAGE_NAME_TC	繁體中文
TextMapData_TextMapContent_LANGUAGE_NAME_EN	English
TextMapData_TextMapContent_LANGUAGE_NAME_FR	Français
TextMapData_TextMapContent_LANGUAGE_NAME_DE	Deutsch
TextMapData_TextMapContent_LANGUAGE_NAME_ES	Español
TextMapData_TextMapContent_LANGUAGE_NAME_PT	Português
TextMapData_TextMapContent_LANGUAGE_NAME_RU	Русский язык
TextMapData_TextMapContent_LANGUAGE_NAME_JP	日本語
TextMapData_TextMapContent_LANGUAGE_NAME_KR	한국어
TextMapData_TextMapContent_LANGUAGE_NAME_TH	ภาษาไทย
TextMapData_TextMapContent_LANGUAGE_NAME_VN	Tiếng Việt
TextMapData_TextMapContent_LANGUAGE_NAME_ID	Bahasa Indonesia
TextMapData_TextMapContent_SHOP_TYPE_PAIMON	內測商店
TextMapData_TextMapContent_SHOP_TYPE_CITY	紀念品商店
TextMapData_TextMapContent_SHOP_TYPE_BLACKSMITH	鐵匠鋪
TextMapData_TextMapContent_SHOP_TYPE_GROCERY	雜貨店
TextMapData_TextMapContent_SHOP_TYPE_FOOD	餐館
TextMapRetData_TextMapContent_RET_FAIL	失敗
TextMapRetData_TextMapContent_RET_SVR_ERROR	伺服器內部錯誤
TextMapRetData_TextMapContent_RET_UNKNOWN_ERROR	未知錯誤
TextMapRetData_TextMapContent_RET_FREQUENT	請求過於頻繁
TextMapRetData_TextMapContent_RET_STOP_REGISTER	您的帳號沒有測試資格，無法進入遊戲。
TextMapRetData_TextMapContent_RET_STOP_SERVER	停服維護中
TextMapRetData_TextMapContent_RET_ACCOUNT_VEIRFY_ERROR	帳號驗證失敗
TextMapRetData_TextMapContent_RET_ACCOUNT_FREEZE	帳號凍結
TextMapRetData_TextMapContent_RET_REPEAT_LOGIN	重複登入
TextMapRetData_TextMapContent_RET_CLIENT_VERSION_ERROR	用戶端版本號錯誤
TextMapRetData_TextMapContent_RET_TOKEN_ERROR	token錯誤
TextMapRetData_TextMapContent_RET_ACCOUNT_NOT_EXIST	帳號不存在
TextMapRetData_TextMapContent_RET_WAIT_OTHER_LOGIN	等待其他設備完成登入
TextMapRetData_TextMapContent_RET_ANOTHER_LOGIN	被其他登入流程打斷
TextMapRetData_TextMapContent_RET_CLIENT_FORCE_UPDATE	用戶端版本太低
TextMapRetData_TextMapContent_RET_BLACK_UID	您的帳號已被封鎖，無法進入遊戲。
TextMapRetData_TextMapContent_RET_LOGIN_DB_FAIL	資料庫讀取失敗
TextMapRetData_TextMapContent_RET_LOGIN_INIT_FAIL	初始化數據失敗
TextMapRetData_TextMapContent_RET_LOGIN_MAX_PLAYER	伺服器繁忙，請稍後再試
TextMapRetData_TextMapContent_RET_AVATAR_IN_CD	角色切換正在冷卻中
TextMapRetData_TextMapContent_RET_AVATAR_NOT_ALIVE	角色無法繼續戰鬥
TextMapRetData_TextMapContent_RET_AVATAR_NOT_ON_SCENE	角色不在地圖上
TextMapRetData_TextMapContent_RET_CAN_NOT_FIND_AVATAR	無法找到該角色
TextMapRetData_TextMapContent_RET_CAN_NOT_DEL_CUR_AVATAR	不能刪除當前的角色
TextMapRetData_TextMapContent_RET_DUPLICATE_AVATAR	角色重複
TextMapRetData_TextMapContent_RET_AVATAR_IS_SAME_ONE	目標角色與當前角色相同
TextMapRetData_TextMapContent_RET_AVATAR_LEVEL_LESS_THAN	角色等級不足
TextMapRetData_TextMapContent_RET_AVATAR_CAN_NOT_CHANGE_ELEMENT	角色不能改變元素類型
TextMapRetData_TextMapContent_RET_AVATAR_BREAK_LEVEL_LESS_THAN	角色突破等級不夠
TextMapRetData_TextMapContent_RET_AVATAR_ON_MAX_BREAK_LEVEL	角色已是最大突破等級
TextMapRetData_TextMapContent_RET_AVATAR_ID_ALREADY_EXIST	相同ID的角色已存在
TextMapRetData_TextMapContent_RET_AVATAR_NOT_DEAD	角色不是死亡狀態
TextMapRetData_TextMapContent_RET_AVATAR_IS_REVIVING	角色在復活中
TextMapRetData_TextMapContent_RET_AVATAR_ID_ERROR	角色ID出錯
TextMapRetData_TextMapContent_RET_REPEAT_SET_PLAYER_BORN_DATA	無法重複設置玩家起始數據
TextMapRetData_TextMapContent_RET_CAN_NOT_FIND_TEAM	找不到隊伍
TextMapRetData_TextMapContent_RET_CAN_NOT_FIND_CUR_TEAM	找不到當前的隊伍
TextMapRetData_TextMapContent_RET_AVATAR_NOT_EXIST_IN_TEAM	角色不在當前隊伍中
TextMapRetData_TextMapContent_RET_CAN_NOT_REMOVE_CUR_AVATAR_FROM_TEAM	不能將當前的角色從隊伍中刪除
TextMapRetData_TextMapContent_RET_CAN_NOT_USE_REVIVE_ITEM_FOR_CUR_AVATAR	不能對出戰角色使用復活道具
TextMapRetData_TextMapContent_RET_TEAM_COST_EXCEED_LIMIT	隊伍COST超過上限
TextMapRetData_TextMapContent_RET_NICKNAME_UTF8_ERROR	暱稱不是有效的utf8字串
TextMapRetData_TextMapContent_RET_NICKNAME_TOO_LONG	暱稱太長
TextMapRetData_TextMapContent_RET_NICKNAME_WORD_ILLEGAL	暱稱含有非法單詞
TextMapRetData_TextMapContent_RET_OPEN_STATE_NOT_OPEN	功能暫未開放
TextMapRetData_TextMapContent_RET_NPC_NOT_EXIST	NPC不存在
TextMapRetData_TextMapContent_RET_NPC_TOO_FAR	NPC距離太遠
TextMapRetData_TextMapContent_RET_NOT_CURRENT_TALK	不是當前對話
TextMapRetData_TextMapContent_RET_NPC_CREATE_FAIL	NPC移動失敗
TextMapRetData_TextMapContent_RET_NPC_MOVE_FAIL	NPC創建失敗
TextMapRetData_TextMapContent_RET_QUEST_NOT_EXIST	任務不存在
TextMapRetData_TextMapContent_RET_QUEST_IS_FAIL	任務已失敗
TextMapRetData_TextMapContent_RET_QUEST_CONTENT_ERROR	任務內容錯誤
TextMapRetData_TextMapContent_RET_POINT_NOT_UNLOCKED	傳送點未解鎖
TextMapRetData_TextMapContent_RET_POINT_TOO_FAR	傳送點距離太遠
TextMapRetData_TextMapContent_RET_POINT_ALREAY_UNLOCKED	傳送點已解鎖
TextMapRetData_TextMapContent_RET_ENTITY_NOT_EXIST	 
TextMapRetData_TextMapContent_RET_ENTER_SCENE_FAIL	進入場景失敗
TextMapRetData_TextMapContent_RET_PLAYER_IS_ENTER_SCENE	正在進入場景中
TextMapRetData_TextMapContent_RET_AREA_MAX_LEVEL	區域已經達到最高等級
TextMapRetData_TextMapContent_RET_AREA_LOCKED	區域尚未解鎖
TextMapRetData_TextMapContent_RET_ITEM_NOT_EXIST	道具不存在
TextMapRetData_TextMapContent_RET_PACK_EXCEED_MAX_WEIGHT	背包超出最大重量
TextMapRetData_TextMapContent_RET_ITEM_NOT_DROPABLE	道具不可丟棄
TextMapRetData_TextMapContent_RET_ITEM_NOT_USABLE	道具不可使用
TextMapRetData_TextMapContent_RET_ITEM_INVALID_USE_COUNT	道具使用數量無效
TextMapRetData_TextMapContent_RET_ITEM_INVALID_DROP_COUNT	道具丟棄數量無效
TextMapRetData_TextMapContent_RET_ITEM_ALREADY_EXIST	道具已經存在
TextMapRetData_TextMapContent_RET_ITEM_IN_COOLDOWN	道具使用在冷卻中
TextMapRetData_TextMapContent_RET_ITEM_COUNT_NOT_ENOUGH	道具數量不夠
TextMapRetData_TextMapContent_RET_ITEM_INVALID_TARGET	目標無效
TextMapRetData_TextMapContent_RET_RECIPE_NOT_EXIST	食譜不存在
TextMapRetData_TextMapContent_RET_RECIPE_LOCKED	食譜尚未解鎖
TextMapRetData_TextMapContent_RET_RECIPE_UNLOCKED	食譜已經解鎖
TextMapRetData_TextMapContent_RET_COMPOUND_QUEUE_FULL	加工列隊已滿
TextMapRetData_TextMapContent_RET_COMPOUND_NOT_FINISH	加工尚未完成
TextMapRetData_TextMapContent_RET_MAIL_ITEM_NOT_GET	信件附件未領取
TextMapRetData_TextMapContent_RET_ITEM_EXCEED_LIMIT	道具數量超過上限
TextMapRetData_TextMapContent_RET_AVATAR_CAN_NOT_USE	尚未獲得該角色，無法使用此道具
TextMapRetData_TextMapContent_RET_ITEM_NEED_PLAYER_LEVEL	冒險等階不足，不能使用
TextMapRetData_TextMapContent_RET_RECIPE_NOT_AUTO_QTE	未達到熟練度上限，食譜無法自動烹飪
TextMapRetData_TextMapContent_RET_COMPOUND_BUSY_QUEUE	加工系統沒有空閒的生產線
TextMapRetData_TextMapContent_RET_EQUIP_LEVEL_HIGHER	裝備所需等級高於角色
TextMapRetData_TextMapContent_RET_EQUIP_CAN_NOT_WAKE_OFF_WEAPON	不能脫下武器
TextMapRetData_TextMapContent_RET_EQUIP_HAS_BEEN_WEARED	裝備已經被穿戴
TextMapRetData_TextMapContent_RET_EQUIP_WEARED_CANNOT_DROP	裝備中無法丟棄
TextMapRetData_TextMapContent_RET_GOODS_NOT_EXIST	商品不存在
TextMapRetData_TextMapContent_RET_GOODS_MATERIAL_NOT_ENOUGH	消耗材料不足
TextMapRetData_TextMapContent_RET_GADGET_NOT_EXIST	物件不存在
TextMapRetData_TextMapContent_RET_GADGET_NOT_INTERACTIVE	物件不可互動
TextMapRetData_TextMapContent_RET_GADGET_NOT_GATHERABLE	物件不可採集
TextMapRetData_TextMapContent_RET_CHEST_IS_LOCKED	寶箱被鎖住
TextMapRetData_TextMapContent_RET_GADGET_CREATE_FAIL	物件創建失敗
TextMapRetData_TextMapContent_RET_WORKTOP_OPTION_NOT_EXIST	操作臺選項不存在
TextMapRetData_TextMapContent_RET_TALENT_ALREAY_UNLOCKED	天賦已解鎖
TextMapRetData_TextMapContent_RET_PREV_TALENT_NOT_UNLOCKED	前置天賦未解鎖
TextMapRetData_TextMapContent_RET_BIG_TALENT_POINT_NOT_ENOUGH	星輝不足
TextMapRetData_TextMapContent_RET_SMALL_TALENT_POINT_NOT_ENOUGH	星塵不足
TextMapRetData_TextMapContent_RET_NEED_MORE_SCOIN	摩拉不足
TextMapRetData_TextMapContent_RET_SKILL_DEPOT_NOT_FOUND	找不到技能庫
TextMapRetData_TextMapContent_RET_HCOIN_NOT_ENOUGH	原石不足
TextMapRetData_TextMapContent_RET_SCOIN_NOT_ENOUGH	摩拉不足
TextMapRetData_TextMapContent_RET_HCOIN_EXCEED_LIMIT	原石超過最大數量
TextMapRetData_TextMapContent_RET_SCOIN_EXCEED_LIMIT	摩拉超過最大數量
TextMapRetData_TextMapContent_RET_MAIL_EXPIRED	過期信件無法領取，並會被刪除
TextMapRetData_TextMapContent_RET_CANDIDATE_SKILL_DEPOT_ID_NOT_FIND	找不到候選技能庫
TextMapRetData_TextMapContent_RET_SKILL_DEPOT_IS_THE_SAME	技能庫ID相同
TextMapRetData_TextMapContent_RET_MONSTER_NOT_EXIST	怪物不存在
TextMapRetData_TextMapContent_RET_MONSTER_CREATE_FAIL	創建怪物失敗
TextMapRetData_TextMapContent_RET_DUNGEON_ENTER_FAIL	副本進入失敗
TextMapRetData_TextMapContent_RET_DUNGEON_QUIT_FAIL	副本退出失敗
TextMapRetData_TextMapContent_RET_DUNGEON_ENTER_EXCEED_DAY_COUNT	已達本日最大副本進入次數
TextMapRetData_TextMapContent_RET_DUNGEON_REVIVE_EXCEED_MAX_COUNT	已達副本最大復活次數
TextMapRetData_TextMapContent_RET_DUNGEON_REVIVE_FAIL	副本復活失敗
TextMapRetData_TextMapContent_RET_DUNGEON_NOT_SUCCEED	副本未成功
TextMapRetData_TextMapContent_RET_DUNGEON_CAN_NOT_CANCEL	副本不可取消
TextMapRetData_TextMapContent_RET_MP_NOT_IN_MY_WORLD	身處他人世界，無法進行該操作
TextMapRetData_TextMapContent_RET_MP_IN_MP_MODE	連線模式中，無法進行該操作
TextMapRetData_TextMapContent_RET_MP_SCENE_IS_FULL	連線玩家數已達上限，無法加入
TextMapRetData_TextMapContent_RET_MP_MODE_NOT_AVAILABLE	目標不能進入連線狀態
TextMapRetData_TextMapContent_RET_MP_PLAYER_NOT_ENTERABLE	玩家無法加入
TextMapRetData_TextMapContent_RET_MP_QUEST_BLOCK_MP	特定任務未完成，不能進入他人世界
TextMapRetData_TextMapContent_RET_MP_IN_ROOM_SCENE 	身處房間中，不能進入他人世界
TextMapRetData_TextMapContent_RET_MAIL_PARA_ERR	信件請求格式錯誤
TextMapRetData_TextMapContent_RET_MAIL_MAX_NUM	信件數量已滿
TextMapRetData_TextMapContent_RET_MAIL_ITEM_NUM_EXCEED	信件附件數量過多
TextMapRetData_TextMapContent_RET_MAIL_TITLE_LEN_EXCEED	信件標題長度超出限制
TextMapRetData_TextMapContent_RET_MAIL_CONTENT_LEN_EXCEED	信件正文長度超出限制
TextMapRetData_TextMapContent_RET_MAIL_SENDER_LEN_EXCEED	信件寄件者長度超出限制
TextMapMsgData_TextMapContent_MSG_UNKNOWN	未知錯誤
TextMapMsgData_TextMapContent_ENET_TIMEOUT	連接逾時
TextMapMsgData_TextMapContent_ENET_SERVER_RELOGIN	帳號在另一處重複登入
TextMapMsgData_TextMapContent_ENET_SERVER_KICK	被伺服器踢下線
TextMapMsgData_TextMapContent_ENET_SERVER_SHUTDOWN	伺服器正在重啟中
TextMapMsgData_TextMapContent_ENET_NOT_FOUND_SESSION	與伺服器的連接不存在
TextMapMsgData_TextMapContent_ENET_LOGIN_UNFINISHED	登入未完成
TextMapMsgData_TextMapContent_ENET_PACKET_FREQ_TOO_HIGH	用戶端發包太頻繁，連接斷開
TextMapMsgData_TextMapContent_ENET_PING_TIMEOUT	伺服器PING超時
TextMapMsgData_TextMapContent_ENET_TRANFER_FAILED	遷移失敗，用戶端重連
TextMapMsgData_TextMapContent_ENET_QUIT_MP	退出連線，斷線重連
TextMapMsgData_TextMapContent_MSG_BLOCK_REFRESH_COUNTDOWN	怪物即將刷新
TextMapMsgData_TextMapContent_MSG_AVATAR_REVIVE_BY_STATUE	在神像的恩澤下，{0}得到了治療