ID	文本
TextMapData_TextMapContent_FightPropType	Combat Attribute Values
TextMapData_TextMapContent_FIGHT_PROP_BASE_HP	HP
TextMapData_TextMapContent_FIGHT_PROP_HP	HP
TextMapData_TextMapContent_FIGHT_PROP_HP_PERCENT	HP Bonus
TextMapData_TextMapContent_FIGHT_PROP_BASE_ATTACK	ATK
TextMapData_TextMapContent_FIGHT_PROP_ATTACK	ATK
TextMapData_TextMapContent_FIGHT_PROP_ATTACK_PERCENT	ATK Bonus
TextMapData_TextMapContent_FIGHT_PROP_BASE_DEFENSE	DEF
TextMapData_TextMapContent_FIGHT_PROP_DEFENSE	DEF
TextMapData_TextMapContent_FIGHT_PROP_DEFENSE_PERCENT	DEF Bonus
TextMapData_TextMapContent_FIGHT_PROP_BASE_SPEED	Movement SPD
TextMapData_TextMapContent_FIGHT_PROP_SPEED_PERCENT	Movement SPD
TextMapData_TextMapContent_FIGHT_PROP_CRITICAL	CRIT Rate
TextMapData_TextMapContent_FIGHT_PROP_ANTI_CRITICAL	CRIT RES
TextMapData_TextMapContent_FIGHT_PROP_CRITICAL_HURT	CRIT DMG
TextMapData_TextMapContent_FIGHT_PROP_CHARGE_EFFICIENCY	Energy Recharge
TextMapData_TextMapContent_FIGHT_PROP_ADD_HURT	DMG Boost
TextMapData_TextMapContent_FIGHT_PROP_SUB_HURT	DMG Reduction
TextMapData_TextMapContent_FIGHT_PROP_HEAL_ADD	Healing Bonus
TextMapData_TextMapContent_FIGHT_PROP_HEALED_ADD	Incoming Healing Bonus
TextMapData_TextMapContent_FIGHT_PROP_FIRE_ADD_HURT	Pyro DMG Bonus
TextMapData_TextMapContent_FIGHT_PROP_FIRE_SUB_HURT	Pyro RES
TextMapData_TextMapContent_FIGHT_PROP_WATER_ADD_HURT	Hydro DMG Bonus
TextMapData_TextMapContent_FIGHT_PROP_WATER_SUB_HURT	Hydro RES
TextMapData_TextMapContent_FIGHT_PROP_GRASS_ADD_HURT	Dendro DMG Bonus
TextMapData_TextMapContent_FIGHT_PROP_GRASS_SUB_HURT	Dendro RES
TextMapData_TextMapContent_FIGHT_PROP_ELEC_ADD_HURT	Electro DMG Bonus
TextMapData_TextMapContent_FIGHT_PROP_ELEC_SUB_HURT	Electro RES
TextMapData_TextMapContent_FIGHT_PROP_ICE_ADD_HURT	Cryo DMG Bonus
TextMapData_TextMapContent_FIGHT_PROP_ICE_SUB_HURT	Cryo RES
TextMapData_TextMapContent_FIGHT_PROP_WIND_ADD_HURT	Anemo DMG Bonus
TextMapData_TextMapContent_FIGHT_PROP_WIND_SUB_HURT	Anemo RES
TextMapData_TextMapContent_FIGHT_PROP_ROCK_ADD_HURT	Geo DMG Bonus
TextMapData_TextMapContent_FIGHT_PROP_ROCK_SUB_HURT	Geo RES
TextMapData_TextMapContent_FIGHT_PROP_EFFECT_HIT	Hit
TextMapData_TextMapContent_FIGHT_PROP_EFFECT_RESIST	Resisted
TextMapData_TextMapContent_FIGHT_PROP_FREEZE_SHORTEN	Frozen Duration Reduction
TextMapData_TextMapContent_FIGHT_PROP_TORPOR_SHORTEN	Paralyzed Duration Reduction
TextMapData_TextMapContent_FIGHT_PROP_DIZZY_SHORTEN	Stunned Duration Reduction
TextMapData_TextMapContent_FIGHT_PROP_MAX_HP	Max HP
TextMapData_TextMapContent_FIGHT_PROP_CUR_ATTACK	ATK
TextMapData_TextMapContent_FIGHT_PROP_CUR_DEFENSE	DEF
TextMapData_TextMapContent_FIGHT_PROP_CUR_SPEED	Movement SPD
TextMapData_TextMapContent_FIGHT_PROP_CUR_HP	HP
TextMapData_TextMapContent_PROP_MAX_STAMINA	Max Stamina
TextMapData_TextMapContent_PROP_TEAM_COST	Cost
TextMapData_TextMapContent_FIGHT_REACTION_BURNING	Burning
TextMapData_TextMapContent_FIGHT_REACTION_WET	Wet
TextMapData_TextMapContent_FIGHT_REACTION_STEAM	Vaporize
TextMapData_TextMapContent_FIGHT_REACTION_GRASS	Grow
TextMapData_TextMapContent_FIGHT_REACTION_SHOCK	Electro-Charged
TextMapData_TextMapContent_FIGHT_REACTION_FROZEN	Frozen
TextMapData_TextMapContent_FIGHT_REACTION_EXPLODE	Overcharged
TextMapData_TextMapContent_FIGHT_REACTION_MELT	Melt
TextMapData_TextMapContent_FIGHT_REACTION_SWIRL	Swirl
TextMapData_TextMapContent_FIGHT_REACTION_SUPERCONDUCTOR	Superconduct
TextMapData_TextMapContent_EquipType	Equipment Type Values
TextMapData_TextMapContent_EQUIP_BRACER	Flower of Life
TextMapData_TextMapContent_EQUIP_DRESS	Circlet of Logos
TextMapData_TextMapContent_EQUIP_SHOES	Sands of Eon
TextMapData_TextMapContent_EQUIP_RING	Goblet of Eonothem
TextMapData_TextMapContent_EQUIP_NECKLACE	Plume of Death
TextMapData_TextMapContent_Topic_LvUp	Level Up!
TextMapData_TextMapContent_Hint_CanNotTakeOffWeapon	Cannot remove weapon
TextMapData_TextMapContent_Hint_NotEnoughLevel	Level too low
TextMapData_TextMapContent_INFO_DANGER_AROUND	Still in danger!
TextMapData_TextMapContent_INFO_TRANSPOINT_GET	Teleport Waypoint unlocked
TextMapData_TextMapContent_INFO_DUNGEON_WAY_POINT_GET	Already connected to Door of Resurrection
TextMapData_TextMapContent_INFO_AVATAR_DIE	Cannot switch to a downed character
TextMapData_TextMapContent_INFO_AVATAR_CHANGE_CD	Character-switching in cooldown
TextMapData_TextMapContent_INFO_AVATAR_CHANGE_LEVEL_FORBIDDEN	Target abnormal
TextMapData_TextMapContent_INFO_AVATAR_CHANGE_IN_PROCESS	Cannot switch character while casting
TextMapData_TextMapContent_INFO_AVATAR_CHANGE_FAIL_AIM	Cannot switch character while aiming
TextMapData_TextMapContent_INFO_AVATAR_CHANGE_FAIL_CLIMB	Cannot switch character while climbing
TextMapData_TextMapContent_INFO_AVATAR_CHANGE_FAIL_FLY	Cannot switch character while gliding
TextMapData_TextMapContent_INFO_AVATAR_CHANGE_FAIL_JUMP	Cannot switch character while jumping
TextMapData_TextMapContent_INFO_AVATAR_CHANGE_FAIL_LADDER	Cannot switch character while climbing
TextMapData_TextMapContent_INFO_AVATAR_CHANGE_FAIL_SWIM	Cannot switch character while swimming
TextMapData_TextMapContent_INFO_AVATAR_CHANGE_FAIL_DEAD	Cannot switch character while downed
TextMapData_TextMapContent_INFO_AVATAR_CHANGE_FAIL_PERFORM	Cannot switch character while sitting
TextMapData_TextMapContent_INFO_AVATAR_CHANGE_LEVEL_TARGETAVATAR	Cannot switch to target character
TextMapData_TextMapContent_INFO_PLAYER_RECONNECT	Reconnecting to server...
TextMapData_TextMapContent_INFO_PLAYER_QUIE_MULTIPLAYER	Leave Multiplayer Mode
TextMapData_TextMapContent_INFO_AVATAR_TRANSPORT_DUNGEON_TITLE	Leave Dungeon
TextMapData_TextMapContent_INFO_AVATAR_TRANSPORT_DUNGEON_DESC	<size=36>Teleporting now will make you leave the dungeon. Continue? </size>\n\n<size=24>All uncollected items will be lost.</size>
TextMapData_TextMapContent_INFO_AVATAR_TRANSPORT_DUNGEON_CANCEL	Stay
TextMapData_TextMapContent_INFO_AVATAR_TRANSPORT_DUNGEON_OK	Teleport
TextMapData_TextMapContent_INFO_CAN_NOT_USE_TRANSPOINT	Cannot teleport in Mondstadt's current state
TextMapData_TextMapContent_INFO_TRANSPOINT_NOT_UNLOCKED	Not yet unlocked
TextMapData_TextMapContent_INFO_AREA_LEVEL_TOO_HIGH	Highly dangerous
TextMapData_TextMapContent_INFO_GET_TRIAL_AVATAR	 
TextMapData_TextMapContent_INFO_PLAYER_EXP_ADD	<color=#37FFFFFF>Adventure EXP +{0}</color>
TextMapData_TextMapContent_INFO_PLAYER_LEVEL_ADD	Adventure Rank increased to {0}
TextMapData_TextMapContent_INFO_MALE_PRONOUN_HE	He
TextMapData_TextMapContent_INFO_FEMALE_PRONOUN_SHE	She
TextMapData_TextMapContent_INFO_MALE_PRONOUN_BROTHER	Brother
TextMapData_TextMapContent_INFO_FEMALE_PRONOUN_SISTER	Sister
TextMapData_TextMapContent_INFO_MALE_PRONOUN_BOY	Boy
TextMapData_TextMapContent_INFO_FEMALE_PRONOUN_GIRL	Girl
TextMapData_TextMapContent_INFO_PLAYER_DEFAULT_NAME	 
TextMapData_TextMapContent_INFO_CHANGE_AVATAR_COST_OVER	Character cost exceeds party cost limit. Please select another character.
TextMapData_TextMapContent_INFO_CHANGE_WEAPON_COST_OVER	Weapon cost exceeds party cost limit. Please select another weapon.
TextMapData_TextMapContent_INFO_WEAPON_BREAK_COST_OVER	Party cost will exceed limit after Ascending. Please remove weapon first before Ascending.
TextMapData_TextMapContent_INFO_SUPPORT_SECOND	Additional Support: 
TextMapData_TextMapContent_INFO_ITEM_NOT_EXIST	Object does not exist
TextMapData_TextMapContent_INFO_ITEM_NOT_INTERACT	Cannot interact with the object
TextMapData_TextMapContent_INFO_ITEM_NOT_GATHER	Object cannot be collected
TextMapData_TextMapContent_INFO_ITEM_ONLY_USEABLE_FOR_ALIVE_AVATAR	Object cannot be used on a downed character
TextMapData_TextMapContent_INFO_ITEM_ONLY_USEABLE_FOR_DEAD_AVATAR	Object can only be used on a downed character
TextMapData_TextMapContent_INFO_BAG_FULL	Inventory full
TextMapData_TextMapContent_INFO_INTERACTION_FAIL_FOCUS	Cannot converse while aiming
TextMapData_TextMapContent_INFO_ELITE_DEFENCE	 
TextMapData_TextMapContent_INFO_NOTICE_ADD_HP	HP already full. Still use?
TextMapData_TextMapContent_SHOP_EXCHANGE_BUTTON	Purchase
TextMapData_TextMapContent_SHOP_LIMITED_PURCHASE	Remaining: {0}
TextMapData_TextMapContent_SHOP_SOLD_OUT	<color=#FF5E41FF>Sold out</color>
TextMapData_TextMapContent_SHOP_FRESH_TIME	Refresh Time: {0}
TextMapData_TextMapContent_BAG_DROP_BUTTON	Discard
TextMapData_TextMapContent_BAG_USE_BUTTON	Use
TextMapData_TextMapContent_BAG_DETAIL_BUTTON	Details
TextMapData_TextMapContent_ITEM_CONSUME	Consumables
TextMapData_TextMapContent_ITEM_FOOD	Food
TextMapData_TextMapContent_ITEM_QUEST	Quest
TextMapData_TextMapContent_ITEM_EQUIP	Artifacts
TextMapData_TextMapContent_ITEM_MATERIAL	Material
TextMapData_TextMapContent_ITEM_EXP_FRUIT	Material
TextMapData_TextMapContent_ITEM_WEAPON	Weapon
TextMapData_TextMapContent_ITEM_AVATAR	Character
TextMapData_TextMapContent_QUEST_NEW	New Quest
TextMapData_TextMapContent_QUEST_REPLACE	Quest Changed
TextMapData_TextMapContent_QUEST_COMPLETE	Quest Completed
TextMapData_TextMapContent_QUEST_FAIL	Quest Failed
TextMapData_TextMapContent_QUEST_REMIND	Quest Hint
TextMapData_TextMapContent_Player_Default_Name	Traveler
TextMapData_TextMapContent_ElementType	Elemental Type Values
TextMapData_TextMapContent_None	N/A
TextMapData_TextMapContent_Fire	Pyro
TextMapData_TextMapContent_Water	Hydro
TextMapData_TextMapContent_Grass	Dendro
TextMapData_TextMapContent_Electric	Electro
TextMapData_TextMapContent_Wind	Anemo
TextMapData_TextMapContent_Ice	Cryo
TextMapData_TextMapContent_Rock	Geo
TextMapData_TextMapContent_TIP_SKIP_CUTSCENE	Skip cutscene?
TextMapData_TextMapContent_DUNGEON_PLOT	Story
TextMapData_TextMapContent_DUNGEON_FIGHT	Combat
TextMapData_TextMapContent_DUNGEON_SUCCESS	Challenge Cleared
TextMapData_TextMapContent_DUNGEON_LOSE	Challenge Failed
TextMapData_TextMapContent_DUNGEON_TIMELIMIT	Dungeon attempt limit reached
TextMapData_TextMapContent_TIP_CHANGE_TIME_TOO_SHORT	Less than {0} min
TextMapData_TextMapContent_PlayerDieType	Failure Types
TextMapData_TextMapContent_PlayerDieNone	All members are down
TextMapData_TextMapContent_PlayerDieKillByMonster	Beware of opponents!
TextMapData_TextMapContent_PlayerDieKillByGear	Watch out for traps!
TextMapData_TextMapContent_PlayerDieFall	Fell to death
TextMapData_TextMapContent_PlayerDieDrawn	Drowned
TextMapData_TextMapContent_PlayerDieAbyss	Fell into the abyss
TextMapData_TextMapContent_SettleShowType	Dungeon Results Calculation Item Types
TextMapData_TextMapContent_SETTLE_SHOW_NONE	Undefined
TextMapData_TextMapContent_SETTLE_SHOW_TIME_COST	Clear Time: 
TextMapData_TextMapContent_SETTLE_SHOW_OPEN_CHEST_COUNT	Secret Chests Found: 
TextMapData_TextMapContent_SETTLE_SHOW_KILL_MONSTER_COUNT	Opponents Defeated: 
TextMapData_TextMapContent_INFO_AREA_EXPLORE_UPDATED	Exploration Progress +{0}
TextMapData_TextMapContent_INFO_DUNGEON_SETTLED_LEAVE_AFTER	Exit in {0} sec
TextMapData_TextMapContent_WeaponType	Weapon Type Values
TextMapData_TextMapContent_WEAPON_NONE	Unknown Weapon
TextMapData_TextMapContent_WEAPON_SWORD_ONE_HAND	Sword
TextMapData_TextMapContent_WEAPON_CROSSBOW	Crossbow
TextMapData_TextMapContent_WEAPON_STAFF	Staff
TextMapData_TextMapContent_WEAPON_DOUBLE_DAGGER	Dual Blades
TextMapData_TextMapContent_WEAPON_KATANA	Tachi
TextMapData_TextMapContent_WEAPON_SHURIKEN	Shuriken
TextMapData_TextMapContent_WEAPON_STICK	Rod
TextMapData_TextMapContent_WEAPON_SPEAR	Pole
TextMapData_TextMapContent_WEAPON_SHIELD_SMALL	Buckler
TextMapData_TextMapContent_WEAPON_CATALYST	Catalyst
TextMapData_TextMapContent_WEAPON_CLAYMORE	Claymore
TextMapData_TextMapContent_WEAPON_BOW	Bow
TextMapData_TextMapContent_WEAPON_POLE	Pole
TextMapData_TextMapContent_INFO_TEAM_CHANGE_AVATAR	Cannot control the current character
TextMapData_TextMapContent_INFO_TEAM_CLOSE_TIP	Exit current menu?
TextMapData_TextMapContent_INFO_TEAM_OPEN_TIP	New character obtained. Check out the new character in your party?
TextMapData_TextMapContent_INFO_TEAM_CANT_OPEN_TIP	Currently cannot open party menu
TextMapData_TextMapContent_INFO_TEAM_LEADER_SKILL_DISABLE	Not Activated
TextMapData_TextMapContent_INFO_TEAM_LEADER_SKILL_TITLE	Leader Talent: 
TextMapData_TextMapContent_INFO_TEAM_LEADER_SKILL_NONE	None
TextMapData_TextMapContent_INFO_TEAM_LEADER_SKILL_TIP	Select a character with a Leader Talent to activate it
TextMapData_TextMapContent_INFO_TEAM_NEED_ALIVE_CHARACTER	All other party members have been downed. Party must contain at least one active member.
TextMapData_TextMapContent_INFO_TEAM_NEED_ONE_CHARACTER	Party must have at least one member
TextMapData_TextMapContent_EQUIP_NO_SLOT_TO_ADD	Slots full!
TextMapData_TextMapContent_EQUIP_WEAPON_LEVEL_OVER_TIP	The selected weapon is of a higher level. Continue?
TextMapData_TextMapContent_EQUIP_WEAPON_BREAK_OVER_TIP	The selected weapon is of a higher Ascension Phase. Continue?
TextMapData_TextMapContent_EQUIP_WEAPON_QUALITY_OVER_TIP	The selected weapon is of a higher quality. Continue?
TextMapData_TextMapContent_EQUIP_WEAPON_LEVEL_MAX_TO_BREAK	Max level reached. Ascend to continue enhancement.
TextMapData_TextMapContent_EQUIP_WEAPON_LEVEL_MAX	Max level reached
TextMapData_TextMapContent_EQUIP_WEAPON_LEVEL_NOT_ENOUGH	Weapon level too low. Enhance to max level to Ascend.
TextMapData_TextMapContent_EQUIP_WEAPON_BREAK_LEVEL_MAX	Max Ascension Phase reached
TextMapData_TextMapContent_EQUIP_WEAPON_BREAK_NEED	Please press to select {1} weapon(s) of {0} Ascension Phase to Ascend
TextMapData_TextMapContent_EQUIP_WEAPON_AWAKEN_LEVEL_MAX	Max Refinement Level reached
TextMapData_TextMapContent_EQUIP_WEAPON_LEVELUP_EXP_OVERFLOW	{0} more EXP than required. Excess EXP will be lost. Proceed?
TextMapData_TextMapContent_EQUIP_RELIC_BREAK_OVER_TIP	The selected Artifact is of a higher Ascension Phase. Continue?
TextMapData_TextMapContent_EQUIP_RELIC_SUBQUALITY_OVER_TIP	The selected Artifact has a better secondary attribute. Continue?
TextMapData_TextMapContent_EQUIP_RELIC_SET_NAME	{0}: 
TextMapData_TextMapContent_EQUIP_RELIC_SET_NUM	{0}-Piece Set: 
TextMapData_TextMapContent_EQUIP_RELIC_LEVEL_NOT_ENOUGH	Weapon level too low. Enhance to max level to Ascend.
TextMapData_TextMapContent_EQUIP_RELIC_BREAK_PROP_ADD	Ascension adds a new bonus attribute
TextMapData_TextMapContent_EQUIP_RELIC_BREAK_PROP_IMPROVE	Ascension upgrades a random bonus attribute
TextMapData_TextMapContent_EQUIP_RELIC_BREAK_MATERIAL_NOT_ENOUGH	Insufficient {0}
TextMapData_TextMapContent_EQUIP_MAX_EXP_TIP	Max EXP reached. Cannot add.
TextMapData_TextMapContent_EQUIP_NO_FOOD_TIP	Select EXP materials
TextMapData_TextMapContent_EQUIP_LEVEL	Lv. {0}
TextMapData_TextMapContent_EQUIP_LEVEL_WITH_MAX	Lv. {0}<color=#FFFFFF9B> / {1}</color>
TextMapData_TextMapContent_EQUIP_SCREEN	Filter
TextMapData_TextMapContent_EQUIP_SCREEN_WITH_NAME	Filter / {0}
TextMapData_TextMapContent_EQUIP_SCREEN_ALL	All
TextMapData_TextMapContent_EQUIP_LEVELUP_SUCCESS	Success
TextMapData_TextMapContent_EQUIP_LEVELUP_SUPER_SUCCESS	2x EXP Enhancement
TextMapData_TextMapContent_EQUIP_LEVELUP_SUPER_GREAT_SUCCESS	5x EXP Enhancement!
TextMapData_TextMapContent_EQUIP_LEVELUP_SUCCESS_TIP	+{0} (x{1}) bonus enhancement(s)!
TextMapData_TextMapContent_EQUIP_FAST_ADD_OVER_TIP	Advanced equipment found among selected materials
TextMapData_TextMapContent_EQUIP_REPLACE_TIP	{0} is currently equipped on {1}. Swap?
TextMapData_TextMapContent_EQUIP_FAST_ADD_NO_FOOD_TIP	No consumables found
TextMapData_TextMapContent_EQUIP_AWAKEN_COUNT_USED_TIP	Refinements Performed: <color=#99FF88FF>{0}</color> / {1}
TextMapData_TextMapContent_EQUIP_AWAKEN_COUNT_UNUSE	Available Refinements
TextMapData_TextMapContent_EQUIP_AWAKEN_FOOD_UNSELECT	No refinement materials selected
TextMapData_TextMapContent_EQUIP_AWAKEN_NEED_NOT_ENOUGH	Insufficient {0}
TextMapData_TextMapContent_SORT_BY_LEVEL	Level
TextMapData_TextMapContent_SORT_BY_COST	Cost
TextMapData_TextMapContent_SORT_BY_QUALITY	Quality
TextMapData_TextMapContent_SORT_BY_EXP	Base EXP
TextMapData_TextMapContent_SORT_BY_ELEMENT	Element
TextMapData_TextMapContent_INFO_MONSTER_SUPPRESS_STAGE_01	Caution! High level threat detected
TextMapData_TextMapContent_INFO_MONSTER_SUPPRESS_STAGE_02	Danger! Exceedingly high level threat detected
TextMapData_TextMapContent_TALENT_LOCK_COLOR	<color=#808080FF>{0}</color>
TextMapData_TextMapContent_TALENT_UNLOCK_COLOR	<color=# FFFFFFFF>{0}</color>
TextMapData_TextMapContent_TALENT_UNLOCK_NEED	{0} needs to reach Lv. {1}
TextMapData_TextMapContent_TALENT_DESCRIPTION	Lv. {0}: {1}
TextMapData_TextMapContent_TALENT_BIG_TYPE	Starglitter Talent
TextMapData_TextMapContent_TALENT_SMALL_TYPE	Stardust Talent
TextMapData_TextMapContent_TALENT_LEVEL_MAX	Max Level
TextMapData_TextMapContent_TALENT_AVATAR_LEVEL_NOT_ENOUGH	Level too low
TextMapData_TextMapContent_TALENT_AVATAR_BREAK_NOT_ENOUGH	Traveler Ascension Phase too low
TextMapData_TextMapContent_TALENT_PRETALENT_UNLOCK	Prerequisite Talent {0} is not activated
TextMapData_TextMapContent_TALENT_POINT_NOT_ENOUGH	Insufficient {0}
TextMapData_TextMapContent_TALENT_POINT_SMALL_NAME	Stardust
TextMapData_TextMapContent_TALENT_POINT_BIG_NAME	Starglitter
TextMapData_TextMapContent_TALENT_AVATAR_LEVEL_NEED	{0} Lv. {1}
TextMapData_TextMapContent_TALENT_CARD_TO_POINT_TIP	Converts the item into <color=#FFFFFF> <size=26>{0}</size> </color> {1}
TextMapData_TextMapContent_TALENT_CARD_USE_NUM_LIMIT_TIP	Max Character Stardust/Starglitter capacity reached 
TextMapData_TextMapContent_AVATAR_TALENT_POINT_SMALL_CHANGE	{0} obtained {1} Stardust
TextMapData_TextMapContent_AVATAR_TALENT_POINT_BIG_CHANGE	{0} obtained {1} Starglitter
TextMapData_TextMapContent_ITEM_NOT_ENOUGH_COLOR	<color=#FF5E41FF>{0}</color>
TextMapData_TextMapContent_ITEM_NEED_OF_CURRENT	{0}/{1}
TextMapData_TextMapContent_INFO_BORED_CREATE_MONSTER	<color=#FF5E41FF>Warning! Elite monsters have appeared!</color>
TextMapData_TextMapContent_INFO_NEW_AVATAR	New Character Obtained: {0}
TextMapData_TextMapContent_INFO_NEW_ITEM	Obtained: {0}
TextMapData_TextMapContent_INFO_SYSTEM_NO_PATH	Cannot find the target from the current location
TextMapData_TextMapContent_INFO_AVATAR_PROMOTE_BEYOND_TEAM_COST	Character will exceed Party Cost after Ascending. Please remove this party member before Ascending.
TextMapData_TextMapContent_INFO_AVATAR_PROMOTE_MATERIAL_NOT_ENOUGH	Insufficient Ascension Materials
TextMapData_TextMapContent_INFO_NAME_IS_TOO_SHORT	Name cannot be less than {0} characters
TextMapData_TextMapContent_INFO_NAME_IS_TOO_LONG	Name cannot exceed {0} characters
TextMapData_TextMapContent_INFO_NAME_HAS_INVALID_CHAR	Name cannot contain {0}
TextMapData_TextMapContent_INFO_NAME_SPACE	Space
TextMapData_TextMapContent_INFO_QUEST_INTERACT_FAIL_FIGHT	Quest dialogue functions disabled during combat
TextMapData_TextMapContent_EQUIP_AFFIX_LEVEL0	Lv. 1
TextMapData_TextMapContent_EQUIP_AFFIX_LEVEL1	Lv. 2
TextMapData_TextMapContent_EQUIP_AFFIX_LEVEL2	Lv. 3
TextMapData_TextMapContent_EQUIP_AFFIX_LEVEL3	Lv. 4
TextMapData_TextMapContent_EQUIP_AFFIX_LEVEL4	Lv. 5
TextMapData_TextMapContent_INFO_FOOD_BUFF	{0} used. {1}{2}
TextMapData_TextMapContent_INFO_Item_Food_RecoverHP	Regenerates HP over a period.
TextMapData_TextMapContent_INFO_Item_Food_RecoverInstantHP	Recovers some HP immediately.
TextMapData_TextMapContent_INFO_Item_Food_Attack	Increases ATK for a time.
TextMapData_TextMapContent_INFO_Item_Food_MoveSpeed	Increases movement SPD for a time.
TextMapData_TextMapContent_INFO_Item_Food_Defence	Increases DEF for a time.
TextMapData_TextMapContent_CONTROL_MOVE_FORWARD	Move Forward
TextMapData_TextMapContent_CONTROL_MOVE_BACKWARD	Move Backward
TextMapData_TextMapContent_CONTROL_MOVE_LEFT	Move Left
TextMapData_TextMapContent_CONTROL_MOVE_RIGHT	Move Right
TextMapData_TextMapContent_CONTROL_SKILL1	Normal Attack
TextMapData_TextMapContent_CONTROL_SKILL2	Elemental Skill
TextMapData_TextMapContent_CONTROL_SPRINT_OR_SKILL3	Sprint
TextMapData_TextMapContent_CONTROL_JUMP_OR_SKILL4	Jump
TextMapData_TextMapContent_CONTROL_SKILL5	Ultimate
TextMapData_TextMapContent_CONTROL_OPEN_BAG	Open Inventory
TextMapData_TextMapContent_CONTROL_OPEN_CHARACTER	Open Character Menu
TextMapData_TextMapContent_CONTROL_OPEN_MAP	Open Map
TextMapData_TextMapContent_CONTROL_OPEN_PAIMEN	Open Paimon Menu
TextMapData_TextMapContent_CONTROL_TOGGLE_QUEST_BOOK	Open Quest Menu
TextMapData_TextMapContent_CONTROL_TO_AVATAR1	Switch Party Character 1
TextMapData_TextMapContent_CONTROL_TO_AVATAR2	Switch Party Character 2
TextMapData_TextMapContent_CONTROL_TO_AVATAR3	Switch Party Character 3
TextMapData_TextMapContent_CONTROL_TO_AVATAR4	Switch Party Character 4
TextMapData_TextMapContent_CONTROL_TO_AVATAR1_TRIGGER_SKILL	Switch to Party Character 1 and use the Ultimate
TextMapData_TextMapContent_CONTROL_TO_AVATAR2_TRIGGER_SKILL	Switch to Party Character 2 and use the Ultimate
TextMapData_TextMapContent_CONTROL_TO_AVATAR3_TRIGGER_SKILL	Switch to Party Character 3 and use the Ultimate
TextMapData_TextMapContent_CONTROL_TO_AVATAR4_TRIGGER_SKILL	Switch to Party Character 4 and use the Ultimate
TextMapData_TextMapContent_CONTROL_TOGGLE_ATTACK_MODE	Switch Aiming Mode
TextMapData_TextMapContent_CONTROL_PICK_TALK	Loot / Interact
TextMapData_TextMapContent_CONTROL_MOVE	Move Character
TextMapData_TextMapContent_CONTROL_VIEW	Rotate Camera
TextMapData_TextMapContent_CONTROL_CHANGE_AVATAR_TRIGGER	Open Character Wheel
TextMapData_TextMapContent_CONTROL_ELEMENT_VIEW	Press and hold to activate Elemental Sight
TextMapData_TextMapContent_CONTROL_HELP	Open the hints page
TextMapData_TextMapContent_CONTROL_SLOW_MOVE	Switch Walk/Run
TextMapData_TextMapContent_KeyCode_Alpha1	1
TextMapData_TextMapContent_KeyCode_Alpha2	2
TextMapData_TextMapContent_KeyCode_Alpha3	3
TextMapData_TextMapContent_KeyCode_Alpha4	4
TextMapData_TextMapContent_KeyCode_Escape	Esc
TextMapData_TextMapContent_KeyCode_LeftControl	Left Ctrl
TextMapData_TextMapContent_KeyCode_LeftAlt	Left-Alt
TextMapData_TextMapContent_KeyCode_LeftShift	Right-Shift
TextMapData_TextMapContent_KeyCode_Mouse0	LMB
TextMapData_TextMapContent_KeyCode_Mouse1	RMB
TextMapData_TextMapContent_KeyCode_Mouse2	MMB
TextMapData_TextMapContent_NEW_AVATAR_GET_TIP	Obtained {0}
TextMapData_TextMapContent_EQUIP_RANK_LEVEL1	 
TextMapData_TextMapContent_EQUIP_RANK_LEVEL2	 
TextMapData_TextMapContent_EQUIP_RANK_LEVEL3	 
TextMapData_TextMapContent_EQUIP_RANK_LEVEL4	 
TextMapData_TextMapContent_EQUIP_RANK_LEVEL5	 
TextMapData_TextMapContent_UI_REPAIR_SKYHARP_PAGE_RESULT_ONE	The Holy Lyre seems rejuvenated.
TextMapData_TextMapContent_UI_REPAIR_SKYHARP_PAGE_RESULT_TWO	The Holy Lyre seems completely different from before. The Anemo power in the area are becoming agitated.
TextMapData_TextMapContent_COOK_COOK	Cook
TextMapData_TextMapContent_COOK_COMPOUND	Craft
TextMapData_TextMapContent_COOK_RANDOM_COOK	Random
TextMapData_TextMapContent_COOK_FOOD_MEAT	Guardian's Recipes
TextMapData_TextMapContent_COOK_FOOD_FRUIT	Brave's Recipes
TextMapData_TextMapContent_COOK_FOOD_STAPLE	Adventurer's Recipes
TextMapData_TextMapContent_COOK_FOOD_SWEET	Sage's Recipes
TextMapData_TextMapContent_COOKING_PAGE_HAVE_NUM	Owned: {0}
TextMapData_TextMapContent_COOKING_PAGE_COMPOUND_QUEUE_SIZE	Max Queue: {0}
TextMapData_TextMapContent_COOKING_PAGE_NOT_ENOUGH_TIP	Insufficient ingredients\n(find more in shops or in the wild)
TextMapData_TextMapContent_COOKING_ITEM_PROFICIENCY	Proficiency: {0}/{1}
TextMapData_TextMapContent_COOKING_ITEM_COOK_NEED	Ingredients
TextMapData_TextMapContent_COOKING_ITEM_COMPOUND_NEED	Crafting Materials
TextMapData_TextMapContent_COOKING_ITEM_COMPOUND_TIME	Crafting Time: {0:F1} min(s)
TextMapData_TextMapContent_COOKING_NEED_FIRE	Light a fire first
TextMapData_TextMapContent_COOKING_QTE_ITEM_QUALITY1	Complete
TextMapData_TextMapContent_COOKING_QTE_ITEM_QUALITY2	Success
TextMapData_TextMapContent_COOKING_QTE_ITEM_QUALITY3	Perfect
TextMapData_TextMapContent_COOKING_QTE_NO_BONUS_DESC	No Character Bonus
TextMapData_TextMapContent_COOKING_COMPOUND_QUEUE_MAX	Queue full
TextMapData_TextMapContent_COOKING_COMPOUND_CURRENT_COUNT	<color=#FFFFFFFF>{0}/{1}</color>
TextMapData_TextMapContent_COOKING_AVATAR_SELECT_CURRENT	{0} <color=#FFCC33FF><size=20>/ current</size></color>
TextMapData_TextMapContent_COOK_BONUS_REPLACE	A chance to obtain special dishes
TextMapData_TextMapContent_COOK_BONUS_PROFICIENCY	Double Proficiency gain
TextMapData_TextMapContent_MAIL_ITEM_NOT_RECEIVE_TIP	Attachments not claimed
TextMapData_TextMapContent_MAIL_CONFIRM_DELETE_TIP	Confirm deletion?
TextMapData_TextMapContent_MAIL_CONFIRM_DELETE_IMPORTANCE_TIP	Priority mail found. Confirm deletion?
TextMapData_TextMapContent_MAIL_DETAIL_SENDER	Sender: {0}
TextMapData_TextMapContent_MAIL_DETAIL_DATE	Time/Date: {0}
TextMapData_TextMapContent_MAIL_MAX_NUM_TIP	The mailbox only retains the newest 1000 mail items.\nMail items with no attachments or claimed attachments will be deleted first when the maximum mail count is exceeded.
TextMapData_TextMapContent_MAIL_NO_ITEM_GET_ALL_TIP	Rewards from all your mail items have already been claimed.
TextMapData_TextMapContent_MAIL_OVER_TIME_SECOND	Just now
TextMapData_TextMapContent_MAIL_OVER_TIME_MINUTE	{0} min
TextMapData_TextMapContent_MAIL_OVER_TIME_HOUR	{0} hr
TextMapData_TextMapContent_MAIL_OVER_TIME_DAY	{0} d
TextMapData_TextMapContent_MAIL_EXPIRE_TIME_DAY	Expires in {0} day(s)
TextMapData_TextMapContent_ITEM_TIP_PLAYER_LEVEL_ITEM	Requires Adventure Rank {0}
TextMapData_TextMapContent_ITEM_TIP_PLAYER_LEVEL_EQUIP	Requires Adventure Rank {0}
TextMapData_TextMapContent_EQUIP_CHANGE_TIP_PLAYER_LEVEL	Requires Adventure Rank {0}
TextMapData_TextMapContent_EQUIP_PLAYER_LEVEL_NOT_ENOUGH_TIP	Required Adventure Rank not yet reached. Cannot equip.
TextMapData_TextMapContent_ITEM_PLAYER_LEVEL_NOT_ENOUGH_TIP	Adventure Rank too low. Cannot be used.
TextMapData_TextMapContent_ITEM_SLOT_COUNT_DOWN_SECOND	{0} sec
TextMapData_TextMapContent_ITEM_SLOT_COUNT_DOWN_MINUTE	{0} min
TextMapData_TextMapContent_ITEM_SLOT_COUNT_DOWN_HOUR	{0} hr
TextMapData_TextMapContent_ITEM_GOT_DIALOG_REASON_MAIL	Attachment
TextMapData_TextMapContent_FETCH_BUTTON_HINT	{0} completed
TextMapData_TextMapContent_COUNT_SELECT_DIALOG_COMPOUND	Select the amount to craft
TextMapData_TextMapContent_PLAYER_MAX_STAMINA_CHANGE	Max stamina increased from {0} to {1}
TextMapData_TextMapContent_OPEN_STATE_AVATAR_PROMOTE	Character Ascension
TextMapData_TextMapContent_OPEN_STATE_AVATAR_TALENT	Character Talent
TextMapData_TextMapContent_OPEN_STATE_WEAPON_PROMOTE	Weapon Ascension
TextMapData_TextMapContent_OPEN_STATE_WEAPON_AWAKEN	Weapon Refinement
TextMapData_TextMapContent_OPEN_STATE_WEAPON_UPGRADE	Weapon Enhancement
TextMapData_TextMapContent_OPEN_STATE_RELIQUARY_PROMOTE	Artifact Ascension
TextMapData_TextMapContent_OPEN_STATE_RELIQUARY_UPGRADE	Artifact Enhancement
TextMapData_TextMapContent_OPEN_STATE_CHANGE_TIP_OPEN	{0} unlocked
TextMapData_TextMapContent_OPEN_STATE_CLOSE_TIP	Not yet available
TextMapData_TextMapContent_OPEN_STATE_CLOSE_TIP_LEVEL	Req: Adventure Rank {0}
TextMapData_TextMapContent_OPEN_STATE_CLOSE_TIP_QUEST	Req: {0} quest completion
TextMapData_TextMapContent_PAGE_TITLE_SEPARATOR	{0} /
TextMapData_TextMapContent_COST_TEXT_MAP_VALUE	Cost
TextMapData_TextMapContent_ITEM_NOT_ENOUGH_COMMON_TIP	Insufficient {0}
TextMapData_TextMapContent_PROP_CHANGE_ADD_TIP	{0} increased by {1}
TextMapData_TextMapContent_PROP_CHANGE_REDUCE_TIP	{0} decreased by {1}
TextMapData_TextMapContent_DUNGEON_MUTIPLAYER_HOST_DIALOG_TIP	Currently in multiplayer mode. Entering a single player dungeon disconnects you from other players. Continue?
TextMapData_TextMapContent_DUNGEON_MUTIPLAYER_HOST_OK_BUTTON	Disconnect
TextMapData_TextMapContent_DUNGEON_MUTIPLAYER_HOST_CANCEL_BUTTON	Cancel
TextMapData_TextMapContent_RET_JOIN_OTHER_WAIT	Starting Multiplayer. Please wait...
TextMapData_TextMapContent_GENERAL_PROMPT_DIALOG_NEW_MAIL_TIP	New Mail
TextMapData_TextMapContent_REWARD_ITEM_GOT_TIP	{0} <color=#FFFFFF80><size=14>×</size></color> {1}
TextMapData_TextMapContent_SHOP_ITEM_REFRESH_FORMAT	yyyy/MM/dd HH:mm
TextMapData_TextMapContent_COMMON_ITEM_COUNT_FORMAT	{0} × {1}
TextMapData_TextMapContent_QUEST_DIALOG_SELECT_PLAYER_LEVEL_NEED	Requires Adventure Rank {0}
TextMapData_TextMapContent_QUEST_DIALOG_DETAIL_PLAYER_LEVEL_NEED	Available from Adventure Rank {0}
TextMapData_TextMapContent_CHAPTER_COMPLETE_DIALOG_TITLE	{0} complete
TextMapData_TextMapContent_CHAPTER_NOTICE_DIALOG_TITLE	{0} {1}\nAvailable from <color=#FFFFFFFF>Adventure Rank{2}</color>
TextMapData_TextMapContent_LOADING_DIALOG_TIPS	Test version. Not indicative of final product.
TextMapData_TextMapContent_LANGUAGE_NAME_SC	简体中文
TextMapData_TextMapContent_LANGUAGE_NAME_TC	繁體中文
TextMapData_TextMapContent_LANGUAGE_NAME_EN	English
TextMapData_TextMapContent_LANGUAGE_NAME_FR	Français
TextMapData_TextMapContent_LANGUAGE_NAME_DE	Deutsch
TextMapData_TextMapContent_LANGUAGE_NAME_ES	Español
TextMapData_TextMapContent_LANGUAGE_NAME_PT	Português
TextMapData_TextMapContent_LANGUAGE_NAME_RU	Русский язык
TextMapData_TextMapContent_LANGUAGE_NAME_JP	日本語
TextMapData_TextMapContent_LANGUAGE_NAME_KR	한국어
TextMapData_TextMapContent_LANGUAGE_NAME_TH	ภาษาไทย
TextMapData_TextMapContent_LANGUAGE_NAME_VN	Tiếng Việt
TextMapData_TextMapContent_LANGUAGE_NAME_ID	Bahasa Indonesia
TextMapData_TextMapContent_SHOP_TYPE_PAIMON	CB Shop
TextMapData_TextMapContent_SHOP_TYPE_CITY	Souvenir Shop
TextMapData_TextMapContent_SHOP_TYPE_BLACKSMITH	Blacksmith
TextMapData_TextMapContent_SHOP_TYPE_GROCERY	Grocery Store
TextMapData_TextMapContent_SHOP_TYPE_FOOD	Restaurant
TextMapRetData_TextMapContent_RET_FAIL	Fail
TextMapRetData_TextMapContent_RET_SVR_ERROR	Internal server error
TextMapRetData_TextMapContent_RET_UNKNOWN_ERROR	Unknown error
TextMapRetData_TextMapContent_RET_FREQUENT	Request too frequent
TextMapRetData_TextMapContent_RET_STOP_REGISTER	Your account is not granted beta access. Game entry denied.
TextMapRetData_TextMapContent_RET_STOP_SERVER	Under maintenance
TextMapRetData_TextMapContent_RET_ACCOUNT_VEIRFY_ERROR	Account authentication failed
TextMapRetData_TextMapContent_RET_ACCOUNT_FREEZE	Account suspended
TextMapRetData_TextMapContent_RET_REPEAT_LOGIN	Duplicate login detected
TextMapRetData_TextMapContent_RET_CLIENT_VERSION_ERROR	Client version error
TextMapRetData_TextMapContent_RET_TOKEN_ERROR	Token error
TextMapRetData_TextMapContent_RET_ACCOUNT_NOT_EXIST	Account does not exist
TextMapRetData_TextMapContent_RET_WAIT_OTHER_LOGIN	Awaiting the other device to log in
TextMapRetData_TextMapContent_RET_ANOTHER_LOGIN	Interrupted by another login process
TextMapRetData_TextMapContent_RET_CLIENT_FORCE_UPDATE	Client version outdated
TextMapRetData_TextMapContent_RET_BLACK_UID	Your account has been suspended. Cannot play Genshin Impact.
TextMapRetData_TextMapContent_RET_LOGIN_DB_FAIL	Failed to read database
TextMapRetData_TextMapContent_RET_LOGIN_INIT_FAIL	Failed to initialize data
TextMapRetData_TextMapContent_RET_LOGIN_MAX_PLAYER	Server busy. Try again later.
TextMapRetData_TextMapContent_RET_AVATAR_IN_CD	Character-switching in cooldown
TextMapRetData_TextMapContent_RET_AVATAR_NOT_ALIVE	Character is downed
TextMapRetData_TextMapContent_RET_AVATAR_NOT_ON_SCENE	Character not in map
TextMapRetData_TextMapContent_RET_CAN_NOT_FIND_AVATAR	Character not found
TextMapRetData_TextMapContent_RET_CAN_NOT_DEL_CUR_AVATAR	Cannot delete the current character
TextMapRetData_TextMapContent_RET_DUPLICATE_AVATAR	Duplicate character
TextMapRetData_TextMapContent_RET_AVATAR_IS_SAME_ONE	Target character is the same as the current character
TextMapRetData_TextMapContent_RET_AVATAR_LEVEL_LESS_THAN	Character level too low
TextMapRetData_TextMapContent_RET_AVATAR_CAN_NOT_CHANGE_ELEMENT	Cannot change the character's elemental type
TextMapRetData_TextMapContent_RET_AVATAR_BREAK_LEVEL_LESS_THAN	Traveler Ascension Phase too low
TextMapRetData_TextMapContent_RET_AVATAR_ON_MAX_BREAK_LEVEL	Character at Max Ascension Phase
TextMapRetData_TextMapContent_RET_AVATAR_ID_ALREADY_EXIST	Character with the same ID already exists
TextMapRetData_TextMapContent_RET_AVATAR_NOT_DEAD	Character is not downed
TextMapRetData_TextMapContent_RET_AVATAR_IS_REVIVING	Character is reviving
TextMapRetData_TextMapContent_RET_AVATAR_ID_ERROR	Character ID error
TextMapRetData_TextMapContent_RET_REPEAT_SET_PLAYER_BORN_DATA	Player's birth data cannot be changed
TextMapRetData_TextMapContent_RET_CAN_NOT_FIND_TEAM	Party not found
TextMapRetData_TextMapContent_RET_CAN_NOT_FIND_CUR_TEAM	Current party not found
TextMapRetData_TextMapContent_RET_AVATAR_NOT_EXIST_IN_TEAM	Character not currently in party
TextMapRetData_TextMapContent_RET_CAN_NOT_REMOVE_CUR_AVATAR_FROM_TEAM	Cannot remove character from the current party
TextMapRetData_TextMapContent_RET_CAN_NOT_USE_REVIVE_ITEM_FOR_CUR_AVATAR	Cannot use Revival Items on deployed characters
TextMapRetData_TextMapContent_RET_TEAM_COST_EXCEED_LIMIT	Party Cost exceeded
TextMapRetData_TextMapContent_RET_NICKNAME_UTF8_ERROR	Nickname is not in valid UTF-8 characters
TextMapRetData_TextMapContent_RET_NICKNAME_TOO_LONG	Nickname too long
TextMapRetData_TextMapContent_RET_NICKNAME_WORD_ILLEGAL	Nickname contains illegal characters
TextMapRetData_TextMapContent_RET_OPEN_STATE_NOT_OPEN	Function not yet available
TextMapRetData_TextMapContent_RET_NPC_NOT_EXIST	NPC does not exist
TextMapRetData_TextMapContent_RET_NPC_TOO_FAR	Too far away from the NPC
TextMapRetData_TextMapContent_RET_NOT_CURRENT_TALK	Not the current dialogue
TextMapRetData_TextMapContent_RET_NPC_CREATE_FAIL	Failed to move NPC
TextMapRetData_TextMapContent_RET_NPC_MOVE_FAIL	Failed to create NPC
TextMapRetData_TextMapContent_RET_QUEST_NOT_EXIST	Quest does not exist
TextMapRetData_TextMapContent_RET_QUEST_IS_FAIL	Quest failed
TextMapRetData_TextMapContent_RET_QUEST_CONTENT_ERROR	Quest contents error
TextMapRetData_TextMapContent_RET_POINT_NOT_UNLOCKED	Teleport Waypoint not yet unlocked
TextMapRetData_TextMapContent_RET_POINT_TOO_FAR	Too far away from the Teleport Waypoint
TextMapRetData_TextMapContent_RET_POINT_ALREAY_UNLOCKED	Teleport Waypoint unlocked
TextMapRetData_TextMapContent_RET_ENTITY_NOT_EXIST	 
TextMapRetData_TextMapContent_RET_ENTER_SCENE_FAIL	Failed to enter the scene
TextMapRetData_TextMapContent_RET_PLAYER_IS_ENTER_SCENE	Entering scene
TextMapRetData_TextMapContent_RET_AREA_MAX_LEVEL	Max Area Level reached
TextMapRetData_TextMapContent_RET_AREA_LOCKED	Area locked
TextMapRetData_TextMapContent_RET_ITEM_NOT_EXIST	Item does not exist
TextMapRetData_TextMapContent_RET_PACK_EXCEED_MAX_WEIGHT	Max Inventory load exceeded
TextMapRetData_TextMapContent_RET_ITEM_NOT_DROPABLE	Cannot discard item
TextMapRetData_TextMapContent_RET_ITEM_NOT_USABLE	Cannot use item
TextMapRetData_TextMapContent_RET_ITEM_INVALID_USE_COUNT	Invalid item amount to use
TextMapRetData_TextMapContent_RET_ITEM_INVALID_DROP_COUNT	Invalid item amount to discard
TextMapRetData_TextMapContent_RET_ITEM_ALREADY_EXIST	Item already exists
TextMapRetData_TextMapContent_RET_ITEM_IN_COOLDOWN	Item in cooldown
TextMapRetData_TextMapContent_RET_ITEM_COUNT_NOT_ENOUGH	Insufficient items
TextMapRetData_TextMapContent_RET_ITEM_INVALID_TARGET	Invalid target
TextMapRetData_TextMapContent_RET_RECIPE_NOT_EXIST	Recipe does not exist
TextMapRetData_TextMapContent_RET_RECIPE_LOCKED	Recipe not yet unlocked
TextMapRetData_TextMapContent_RET_RECIPE_UNLOCKED	Recipe unlocked
TextMapRetData_TextMapContent_RET_COMPOUND_QUEUE_FULL	Crafting Queue full
TextMapRetData_TextMapContent_RET_COMPOUND_NOT_FINISH	Crafting not yet complete
TextMapRetData_TextMapContent_RET_MAIL_ITEM_NOT_GET	Attachments not claimed
TextMapRetData_TextMapContent_RET_ITEM_EXCEED_LIMIT	Exceeding max item use amount
TextMapRetData_TextMapContent_RET_AVATAR_CAN_NOT_USE	Character not acquired. Cannot use item.
TextMapRetData_TextMapContent_RET_ITEM_NEED_PLAYER_LEVEL	Adventure Rank too low. Cannot use.
TextMapRetData_TextMapContent_RET_RECIPE_NOT_AUTO_QTE	Max proficiency not reached. Cannot auto-cook.
TextMapRetData_TextMapContent_RET_COMPOUND_BUSY_QUEUE	No avaliable queue for crafting
TextMapRetData_TextMapContent_RET_EQUIP_LEVEL_HIGHER	Item requirement level exceeds character level
TextMapRetData_TextMapContent_RET_EQUIP_CAN_NOT_WAKE_OFF_WEAPON	Cannot remove weapon
TextMapRetData_TextMapContent_RET_EQUIP_HAS_BEEN_WEARED	Already equipped
TextMapRetData_TextMapContent_RET_EQUIP_WEARED_CANNOT_DROP	Equipped. Cannot discard.
TextMapRetData_TextMapContent_RET_GOODS_NOT_EXIST	Merchandise does not exist
TextMapRetData_TextMapContent_RET_GOODS_MATERIAL_NOT_ENOUGH	Insufficient materials
TextMapRetData_TextMapContent_RET_GADGET_NOT_EXIST	Object does not exist
TextMapRetData_TextMapContent_RET_GADGET_NOT_INTERACTIVE	Cannot interact with the object
TextMapRetData_TextMapContent_RET_GADGET_NOT_GATHERABLE	Object cannot be collected
TextMapRetData_TextMapContent_RET_CHEST_IS_LOCKED	Chest locked
TextMapRetData_TextMapContent_RET_GADGET_CREATE_FAIL	Failed to create object
TextMapRetData_TextMapContent_RET_WORKTOP_OPTION_NOT_EXIST	Console option does not exist
TextMapRetData_TextMapContent_RET_TALENT_ALREAY_UNLOCKED	Talent unlocked
TextMapRetData_TextMapContent_RET_PREV_TALENT_NOT_UNLOCKED	Prerequisite Talent has not yet been unlocked
TextMapRetData_TextMapContent_RET_BIG_TALENT_POINT_NOT_ENOUGH	Insufficient Starglitter
TextMapRetData_TextMapContent_RET_SMALL_TALENT_POINT_NOT_ENOUGH	Insufficient Stardust
TextMapRetData_TextMapContent_RET_NEED_MORE_SCOIN	Insufficient Mora
TextMapRetData_TextMapContent_RET_SKILL_DEPOT_NOT_FOUND	Skill Depot not found
TextMapRetData_TextMapContent_RET_HCOIN_NOT_ENOUGH	Insufficient Primogems
TextMapRetData_TextMapContent_RET_SCOIN_NOT_ENOUGH	Insufficient Mora
TextMapRetData_TextMapContent_RET_HCOIN_EXCEED_LIMIT	Primogem exceeds maximum limit
TextMapRetData_TextMapContent_RET_SCOIN_EXCEED_LIMIT	Mora exceeds maximum limit
TextMapRetData_TextMapContent_RET_MAIL_EXPIRED	Expired mails cannot be claimed and will be deleted
TextMapRetData_TextMapContent_RET_CANDIDATE_SKILL_DEPOT_ID_NOT_FIND	Candidate Skill Depot not found
TextMapRetData_TextMapContent_RET_SKILL_DEPOT_IS_THE_SAME	Duplicate Skill Depot ID
TextMapRetData_TextMapContent_RET_MONSTER_NOT_EXIST	Monster does not exist
TextMapRetData_TextMapContent_RET_MONSTER_CREATE_FAIL	Failed to create monster
TextMapRetData_TextMapContent_RET_DUNGEON_ENTER_FAIL	Failed to enter Dungeon
TextMapRetData_TextMapContent_RET_DUNGEON_QUIT_FAIL	Failed to exit Dungeon
TextMapRetData_TextMapContent_RET_DUNGEON_ENTER_EXCEED_DAY_COUNT	Max daily dungeon challenge attempts reached
TextMapRetData_TextMapContent_RET_DUNGEON_REVIVE_EXCEED_MAX_COUNT	Max dungeon revives reached
TextMapRetData_TextMapContent_RET_DUNGEON_REVIVE_FAIL	Failed to revive in Dungeon
TextMapRetData_TextMapContent_RET_DUNGEON_NOT_SUCCEED	Dungeon failed
TextMapRetData_TextMapContent_RET_DUNGEON_CAN_NOT_CANCEL	Dungeon cannot be canceled
TextMapRetData_TextMapContent_RET_MP_NOT_IN_MY_WORLD	You are in another player's world. Action not permitted.
TextMapRetData_TextMapContent_RET_MP_IN_MP_MODE	You are in multiplayer mode. Action not permitted.
TextMapRetData_TextMapContent_RET_MP_SCENE_IS_FULL	Max multiplayer player count reached. Cannot join.
TextMapRetData_TextMapContent_RET_MP_MODE_NOT_AVAILABLE	Target player cannot initiate multiplayer mode
TextMapRetData_TextMapContent_RET_MP_PLAYER_NOT_ENTERABLE	Player cannot join
TextMapRetData_TextMapContent_RET_MP_QUEST_BLOCK_MP	Designated quest not complete. Cannot enter another player's world.
TextMapRetData_TextMapContent_RET_MP_IN_ROOM_SCENE 	Cannot join another player's session while indoors.
TextMapRetData_TextMapContent_RET_MAIL_PARA_ERR	Mail request format error
TextMapRetData_TextMapContent_RET_MAIL_MAX_NUM	Mailbox full
TextMapRetData_TextMapContent_RET_MAIL_ITEM_NUM_EXCEED	Mail attachments full
TextMapRetData_TextMapContent_RET_MAIL_TITLE_LEN_EXCEED	Mail subject length exceeds maximum limit
TextMapRetData_TextMapContent_RET_MAIL_CONTENT_LEN_EXCEED	Mail content exceeds maximum limit
TextMapRetData_TextMapContent_RET_MAIL_SENDER_LEN_EXCEED	Mail sender length exceeds maximum limit
TextMapMsgData_TextMapContent_MSG_UNKNOWN	Unknown error
TextMapMsgData_TextMapContent_ENET_TIMEOUT	Connection timed out
TextMapMsgData_TextMapContent_ENET_SERVER_RELOGIN	Account has logged in from another device
TextMapMsgData_TextMapContent_ENET_SERVER_KICK	Disconnected
TextMapMsgData_TextMapContent_ENET_SERVER_SHUTDOWN	Server restarting...
TextMapMsgData_TextMapContent_ENET_NOT_FOUND_SESSION	No server connection
TextMapMsgData_TextMapContent_ENET_LOGIN_UNFINISHED	Login incomplete
TextMapMsgData_TextMapContent_ENET_PACKET_FREQ_TOO_HIGH	Data communication frequency too high. Disconnected.
TextMapMsgData_TextMapContent_ENET_PING_TIMEOUT	Server ping timed out
TextMapMsgData_TextMapContent_ENET_TRANFER_FAILED	Failed to transfer. Reconnecting to client.
TextMapMsgData_TextMapContent_ENET_QUIT_MP	Quitting MP. Reconnecting from disconnection.
TextMapMsgData_TextMapContent_MSG_BLOCK_REFRESH_COUNTDOWN	Monsters are about to respawn
TextMapMsgData_TextMapContent_MSG_AVATAR_REVIVE_BY_STATUE	{0} received the Statue's Blessing and has been revived