ID	文本
TextMapData_TextMapContent_FightPropType	战斗属性枚举
TextMapData_TextMapContent_FIGHT_PROP_BASE_HP	生命值
TextMapData_TextMapContent_FIGHT_PROP_HP	生命值
TextMapData_TextMapContent_FIGHT_PROP_HP_PERCENT	生命值加成
TextMapData_TextMapContent_FIGHT_PROP_BASE_ATTACK	攻击力
TextMapData_TextMapContent_FIGHT_PROP_ATTACK	攻击力
TextMapData_TextMapContent_FIGHT_PROP_ATTACK_PERCENT	攻击力加成
TextMapData_TextMapContent_FIGHT_PROP_BASE_DEFENSE	防御力
TextMapData_TextMapContent_FIGHT_PROP_DEFENSE	防御力
TextMapData_TextMapContent_FIGHT_PROP_DEFENSE_PERCENT	防御力加成
TextMapData_TextMapContent_FIGHT_PROP_BASE_SPEED	移动速度
TextMapData_TextMapContent_FIGHT_PROP_SPEED_PERCENT	移动速度
TextMapData_TextMapContent_FIGHT_PROP_CRITICAL	暴击率
TextMapData_TextMapContent_FIGHT_PROP_ANTI_CRITICAL	暴击抗性
TextMapData_TextMapContent_FIGHT_PROP_CRITICAL_HURT	暴击伤害
TextMapData_TextMapContent_FIGHT_PROP_CHARGE_EFFICIENCY	元素充能效率
TextMapData_TextMapContent_FIGHT_PROP_ADD_HURT	伤害增加
TextMapData_TextMapContent_FIGHT_PROP_SUB_HURT	受伤减免
TextMapData_TextMapContent_FIGHT_PROP_HEAL_ADD	治疗加成
TextMapData_TextMapContent_FIGHT_PROP_HEALED_ADD	受治疗加成
TextMapData_TextMapContent_FIGHT_PROP_FIRE_ADD_HURT	火元素伤害加成
TextMapData_TextMapContent_FIGHT_PROP_FIRE_SUB_HURT	火元素抗性
TextMapData_TextMapContent_FIGHT_PROP_WATER_ADD_HURT	水元素伤害加成
TextMapData_TextMapContent_FIGHT_PROP_WATER_SUB_HURT	水元素抗性
TextMapData_TextMapContent_FIGHT_PROP_GRASS_ADD_HURT	草元素伤害加成
TextMapData_TextMapContent_FIGHT_PROP_GRASS_SUB_HURT	草元素抗性
TextMapData_TextMapContent_FIGHT_PROP_ELEC_ADD_HURT	雷元素伤害加成
TextMapData_TextMapContent_FIGHT_PROP_ELEC_SUB_HURT	雷元素抗性
TextMapData_TextMapContent_FIGHT_PROP_ICE_ADD_HURT	冰元素伤害加成
TextMapData_TextMapContent_FIGHT_PROP_ICE_SUB_HURT	冰元素抗性
TextMapData_TextMapContent_FIGHT_PROP_WIND_ADD_HURT	风元素伤害加成
TextMapData_TextMapContent_FIGHT_PROP_WIND_SUB_HURT	风元素抗性
TextMapData_TextMapContent_FIGHT_PROP_ROCK_ADD_HURT	岩元素伤害加成
TextMapData_TextMapContent_FIGHT_PROP_ROCK_SUB_HURT	岩元素抗性
TextMapData_TextMapContent_FIGHT_PROP_EFFECT_HIT	效果命中
TextMapData_TextMapContent_FIGHT_PROP_EFFECT_RESIST	效果抵抗
TextMapData_TextMapContent_FIGHT_PROP_FREEZE_SHORTEN	冻结时间缩短
TextMapData_TextMapContent_FIGHT_PROP_TORPOR_SHORTEN	麻痹时间缩短
TextMapData_TextMapContent_FIGHT_PROP_DIZZY_SHORTEN	眩晕时间缩短
TextMapData_TextMapContent_FIGHT_PROP_MAX_HP	生命值上限
TextMapData_TextMapContent_FIGHT_PROP_CUR_ATTACK	攻击力
TextMapData_TextMapContent_FIGHT_PROP_CUR_DEFENSE	防御力
TextMapData_TextMapContent_FIGHT_PROP_CUR_SPEED	移动速度
TextMapData_TextMapContent_FIGHT_PROP_CUR_HP	生命值
TextMapData_TextMapContent_PROP_MAX_STAMINA	体力上限
TextMapData_TextMapContent_PROP_TEAM_COST	Cost
TextMapData_TextMapContent_FIGHT_REACTION_BURNING	燃烧
TextMapData_TextMapContent_FIGHT_REACTION_WET	潮湿
TextMapData_TextMapContent_FIGHT_REACTION_STEAM	蒸发
TextMapData_TextMapContent_FIGHT_REACTION_GRASS	生长
TextMapData_TextMapContent_FIGHT_REACTION_SHOCK	感电
TextMapData_TextMapContent_FIGHT_REACTION_FROZEN	冻结
TextMapData_TextMapContent_FIGHT_REACTION_EXPLODE	超载
TextMapData_TextMapContent_FIGHT_REACTION_MELT	融化
TextMapData_TextMapContent_FIGHT_REACTION_SWIRL	扩散
TextMapData_TextMapContent_FIGHT_REACTION_SUPERCONDUCTOR	超导
TextMapData_TextMapContent_EquipType	装备类型枚举
TextMapData_TextMapContent_EQUIP_BRACER	生之花
TextMapData_TextMapContent_EQUIP_DRESS	理之冠
TextMapData_TextMapContent_EQUIP_SHOES	时之沙
TextMapData_TextMapContent_EQUIP_RING	空之杯
TextMapData_TextMapContent_EQUIP_NECKLACE	死之羽
TextMapData_TextMapContent_Topic_LvUp	角色升级了
TextMapData_TextMapContent_Hint_CanNotTakeOffWeapon	无法卸下武器
TextMapData_TextMapContent_Hint_NotEnoughLevel	等级不足
TextMapData_TextMapContent_INFO_DANGER_AROUND	附近还有危险！
TextMapData_TextMapContent_INFO_TRANSPOINT_GET	传送锚点解锁
TextMapData_TextMapContent_INFO_DUNGEON_WAY_POINT_GET	与复苏之门已建立联系
TextMapData_TextMapContent_INFO_AVATAR_DIE	角色无法战斗
TextMapData_TextMapContent_INFO_AVATAR_CHANGE_CD	换人还在CD中
TextMapData_TextMapContent_INFO_AVATAR_CHANGE_LEVEL_FORBIDDEN	目标异常
TextMapData_TextMapContent_INFO_AVATAR_CHANGE_IN_PROCESS	角色释放技能中
TextMapData_TextMapContent_INFO_AVATAR_CHANGE_FAIL_AIM	瞄准时不可换人
TextMapData_TextMapContent_INFO_AVATAR_CHANGE_FAIL_CLIMB	攀爬时不能切换角色
TextMapData_TextMapContent_INFO_AVATAR_CHANGE_FAIL_FLY	飞行时不能切换角色
TextMapData_TextMapContent_INFO_AVATAR_CHANGE_FAIL_JUMP	跳跃时不能切换角色
TextMapData_TextMapContent_INFO_AVATAR_CHANGE_FAIL_LADDER	攀爬时不能切换角色
TextMapData_TextMapContent_INFO_AVATAR_CHANGE_FAIL_SWIM	游泳时不能切换角色
TextMapData_TextMapContent_INFO_AVATAR_CHANGE_FAIL_DEAD	倒下时不能切换角色
TextMapData_TextMapContent_INFO_AVATAR_CHANGE_FAIL_PERFORM	坐下时不能切换角色
TextMapData_TextMapContent_INFO_AVATAR_CHANGE_LEVEL_TARGETAVATAR	无法切换目标角色
TextMapData_TextMapContent_INFO_PLAYER_RECONNECT	重新连接服务器
TextMapData_TextMapContent_INFO_PLAYER_QUIE_MULTIPLAYER	退出联机
TextMapData_TextMapContent_INFO_AVATAR_TRANSPORT_DUNGEON_TITLE	退出地城
TextMapData_TextMapContent_INFO_AVATAR_TRANSPORT_DUNGEON_DESC	<size=36>现在传送将退出地城，是否继续？</size>\n\n<size=24>未捡拾物品将丢失，暂时无法寻回</size>
TextMapData_TextMapContent_INFO_AVATAR_TRANSPORT_DUNGEON_CANCEL	返回地城
TextMapData_TextMapContent_INFO_AVATAR_TRANSPORT_DUNGEON_OK	继续传送
TextMapData_TextMapContent_INFO_CAN_NOT_USE_TRANSPOINT	蒙德城被封锁，目前无法传送
TextMapData_TextMapContent_INFO_TRANSPOINT_NOT_UNLOCKED	尚未解锁
TextMapData_TextMapContent_INFO_AREA_LEVEL_TOO_HIGH	高危险度
TextMapData_TextMapContent_INFO_GET_TRIAL_AVATAR	
TextMapData_TextMapContent_INFO_PLAYER_EXP_ADD	<color=#37FFFFFF>冒险阅历 +{0}</color>
TextMapData_TextMapContent_INFO_PLAYER_LEVEL_ADD	冒险等阶提升至{0}
TextMapData_TextMapContent_INFO_MALE_PRONOUN_HE	他
TextMapData_TextMapContent_INFO_FEMALE_PRONOUN_SHE	她
TextMapData_TextMapContent_INFO_MALE_PRONOUN_BROTHER	哥哥
TextMapData_TextMapContent_INFO_FEMALE_PRONOUN_SISTER	妹妹
TextMapData_TextMapContent_INFO_MALE_PRONOUN_BOY	少年
TextMapData_TextMapContent_INFO_FEMALE_PRONOUN_GIRL	少女
TextMapData_TextMapContent_INFO_PLAYER_DEFAULT_NAME	
TextMapData_TextMapContent_INFO_MALE_PRONOUN_HE_LOWER_SUBJECT	he
TextMapData_TextMapContent_INFO_FEMALE_PRONOUN_SHE_LOWER_SUBJECT	she
TextMapData_TextMapContent_INFO_MALE_PRONOUN_HIM_UPPER_OBJECT	Him
TextMapData_TextMapContent_INFO_FEMALE_PRONOUN_HER_UPPER_OBJECT	Her
TextMapData_TextMapContent_INFO_MALE_PRONOUN_HIM_LOWER_OBJECT	him
TextMapData_TextMapContent_INFO_FEMALE_PRONOUN_HER_LOWER_OBJECT	her
TextMapData_TextMapContent_INFO_MALE_PRONOUN_HIS_UPPER_GENITIVE	His
TextMapData_TextMapContent_INFO_FEMALE_PRONOUN_HER_UPPER_GENITIVE	Her
TextMapData_TextMapContent_INFO_MALE_PRONOUN_HIS_LOWER_GENITIVE	his
TextMapData_TextMapContent_INFO_FEMALE_PRONOUN_HER_LOWER_GENITIVE	her
TextMapData_TextMapContent_INFO_MALE_PRONOUN_BROTHER_LOWER	brother
TextMapData_TextMapContent_INFO_FEMALE_PRONOUN_SISTER_LOWER	sister
TextMapData_TextMapContent_INFO_MALE_PRONOUN_BOY_LOWER	boy
TextMapData_TextMapContent_INFO_FEMALE_PRONOUN_GIRL_LOWER	girl
TextMapData_TextMapContent_INFO_CHANGE_AVATAR_COST_OVER	所换角色Cost超过队伍消耗上限，可尝试更换其他角色
TextMapData_TextMapContent_INFO_CHANGE_WEAPON_COST_OVER	所换武器Cost超过队伍消耗上限，可尝试更换其他武器
TextMapData_TextMapContent_INFO_WEAPON_BREAK_COST_OVER	武器突破后Cost将超出队伍消耗上限，可尝试取下后进行突破
TextMapData_TextMapContent_INFO_SUPPORT_SECOND	追加援助：
TextMapData_TextMapContent_INFO_ITEM_NOT_EXIST	物品不存在
TextMapData_TextMapContent_INFO_ITEM_NOT_INTERACT	物品不能交互
TextMapData_TextMapContent_INFO_ITEM_NOT_GATHER	物品不能采集
TextMapData_TextMapContent_INFO_ITEM_ONLY_USEABLE_FOR_ALIVE_AVATAR	物品无法对倒下的角色使用
TextMapData_TextMapContent_INFO_ITEM_ONLY_USEABLE_FOR_DEAD_AVATAR	物品只能对倒下的角色使用
TextMapData_TextMapContent_INFO_BAG_FULL	背包已满
TextMapData_TextMapContent_INFO_INTERACTION_FAIL_FOCUS	瞄准状态下无法对话
TextMapData_TextMapContent_INFO_ELITE_DEFENCE	
TextMapData_TextMapContent_INFO_NOTICE_ADD_HP	生命值已满，是否继续使用？
TextMapData_TextMapContent_SHOP_EXCHANGE_BUTTON	兑换
TextMapData_TextMapContent_SHOP_LIMITED_PURCHASE	剩余数量：{0}
TextMapData_TextMapContent_SHOP_SOLD_OUT	<color=#FF5E41FF>已售罄</color>
TextMapData_TextMapContent_SHOP_FRESH_TIME	刷新时间：{0}
TextMapData_TextMapContent_BAG_DROP_BUTTON	丢弃
TextMapData_TextMapContent_BAG_USE_BUTTON	使用
TextMapData_TextMapContent_BAG_DETAIL_BUTTON	详情
TextMapData_TextMapContent_ITEM_CONSUME	消耗品
TextMapData_TextMapContent_ITEM_FOOD	食物
TextMapData_TextMapContent_ITEM_QUEST	任务
TextMapData_TextMapContent_ITEM_EQUIP	圣遗物
TextMapData_TextMapContent_ITEM_MATERIAL	材料
TextMapData_TextMapContent_ITEM_EXP_FRUIT	材料
TextMapData_TextMapContent_ITEM_WEAPON	武器
TextMapData_TextMapContent_ITEM_AVATAR	角色
TextMapData_TextMapContent_QUEST_NEW	新任务
TextMapData_TextMapContent_QUEST_REPLACE	任务变更
TextMapData_TextMapContent_QUEST_COMPLETE	任务完成
TextMapData_TextMapContent_QUEST_FAIL	任务失败
TextMapData_TextMapContent_QUEST_REMIND	任务提示
TextMapData_TextMapContent_Player_Default_Name	旅行者
TextMapData_TextMapContent_ElementType	元素类型枚举
TextMapData_TextMapContent_None	无
TextMapData_TextMapContent_Fire	火元素
TextMapData_TextMapContent_Water	水元素
TextMapData_TextMapContent_Grass	草元素
TextMapData_TextMapContent_Electric	雷元素
TextMapData_TextMapContent_Wind	风元素
TextMapData_TextMapContent_Ice	冰元素
TextMapData_TextMapContent_Rock	岩元素
TextMapData_TextMapContent_TIP_SKIP_CUTSCENE	是否跳过？
TextMapData_TextMapContent_DUNGEON_PLOT	剧情
TextMapData_TextMapContent_DUNGEON_FIGHT	战斗
TextMapData_TextMapContent_DUNGEON_SUCCESS	挑战成功
TextMapData_TextMapContent_DUNGEON_LOSE	挑战失败
TextMapData_TextMapContent_DUNGEON_TIMELIMIT	已达地城最大进入次数
TextMapData_TextMapContent_TIP_CHANGE_TIME_TOO_SHORT	时间少于{0}分钟
TextMapData_TextMapContent_PlayerDieType	失败类型
TextMapData_TextMapContent_PlayerDieNone	全部队员已倒下
TextMapData_TextMapContent_PlayerDieKillByMonster	注意敌人
TextMapData_TextMapContent_PlayerDieKillByGear	小心机关
TextMapData_TextMapContent_PlayerDieFall	坠落
TextMapData_TextMapContent_PlayerDieDrawn	溺水
TextMapData_TextMapContent_PlayerDieAbyss	坠入深渊
TextMapData_TextMapContent_SettleShowType	地下城结算显示条目类型
TextMapData_TextMapContent_SETTLE_SHOW_NONE	未定义
TextMapData_TextMapContent_SETTLE_SHOW_TIME_COST	通关时间：
TextMapData_TextMapContent_SETTLE_SHOW_OPEN_CHEST_COUNT	秘密宝箱获得：
TextMapData_TextMapContent_SETTLE_SHOW_KILL_MONSTER_COUNT	杀死怪物：
TextMapData_TextMapContent_INFO_AREA_EXPLORE_UPDATED	{0}探索度增加
TextMapData_TextMapContent_INFO_DUNGEON_SETTLED_LEAVE_AFTER	{0}秒后退出
TextMapData_TextMapContent_WeaponType	武器类型枚举
TextMapData_TextMapContent_WEAPON_NONE	未知武器
TextMapData_TextMapContent_WEAPON_SWORD_ONE_HAND	单手剑
TextMapData_TextMapContent_WEAPON_CROSSBOW	弩
TextMapData_TextMapContent_WEAPON_STAFF	法杖
TextMapData_TextMapContent_WEAPON_DOUBLE_DAGGER	双短刀
TextMapData_TextMapContent_WEAPON_KATANA	太刀
TextMapData_TextMapContent_WEAPON_SHURIKEN	手里剑
TextMapData_TextMapContent_WEAPON_STICK	棍
TextMapData_TextMapContent_WEAPON_SPEAR	长柄
TextMapData_TextMapContent_WEAPON_SHIELD_SMALL	小盾
TextMapData_TextMapContent_WEAPON_CATALYST	法器
TextMapData_TextMapContent_WEAPON_CLAYMORE	双手剑
TextMapData_TextMapContent_WEAPON_BOW	弓
TextMapData_TextMapContent_WEAPON_POLE	长柄
TextMapData_TextMapContent_INFO_TEAM_CHANGE_AVATAR	无法操作正在使用的角色
TextMapData_TextMapContent_INFO_TEAM_CLOSE_TIP	是否确认退出当前界面？
TextMapData_TextMapContent_INFO_TEAM_OPEN_TIP	获得新角色，是否打开队伍界面查看新角色？
TextMapData_TextMapContent_INFO_TEAM_CANT_OPEN_TIP	当前状态不可打开队伍界面
TextMapData_TextMapContent_INFO_TEAM_LEADER_SKILL_DISABLE	未激活
TextMapData_TextMapContent_INFO_TEAM_LEADER_SKILL_TITLE	队长技：
TextMapData_TextMapContent_INFO_TEAM_LEADER_SKILL_NONE	暂无
TextMapData_TextMapContent_INFO_TEAM_LEADER_SKILL_TIP	请选择持有队长技的角色激活队长技
TextMapData_TextMapContent_INFO_TEAM_NEED_ALIVE_CHARACTER	其他队友已倒下，队伍中至少保留一个可行动的角色
TextMapData_TextMapContent_INFO_TEAM_NEED_ONE_CHARACTER	队伍中至少保留一名角色
TextMapData_TextMapContent_EQUIP_NO_SLOT_TO_ADD	当前无空位放入
TextMapData_TextMapContent_EQUIP_WEAPON_LEVEL_OVER_TIP	所选武器等级较高，是否继续？
TextMapData_TextMapContent_EQUIP_WEAPON_BREAK_OVER_TIP	所选武器突破等级较高，是否继续？
TextMapData_TextMapContent_EQUIP_WEAPON_QUALITY_OVER_TIP	所选武器品质较高，是否继续？
TextMapData_TextMapContent_EQUIP_WEAPON_LEVEL_MAX_TO_BREAK	已达到当前等级上限，请前往突破页面
TextMapData_TextMapContent_EQUIP_WEAPON_LEVEL_MAX	已达到当前等级上限
TextMapData_TextMapContent_EQUIP_WEAPON_LEVEL_NOT_ENOUGH	武器等级不足，不能突破
TextMapData_TextMapContent_EQUIP_WEAPON_BREAK_LEVEL_MAX	已达到当前突破等级上限
TextMapData_TextMapContent_EQUIP_WEAPON_BREAK_NEED	请点选放入{0}个突破等级为{1}的武器才可突破
TextMapData_TextMapContent_EQUIP_WEAPON_AWAKEN_LEVEL_MAX	已达到当前精炼等级上限
TextMapData_TextMapContent_EQUIP_WEAPON_LEVELUP_EXP_OVERFLOW	本次强化经验溢出{0}点（不返还），是否继续？
TextMapData_TextMapContent_EQUIP_RELIC_BREAK_OVER_TIP	所选圣遗物突破等级较高，是否继续？
TextMapData_TextMapContent_EQUIP_RELIC_SUBQUALITY_OVER_TIP	所选圣遗物副属性较高，是否继续？
TextMapData_TextMapContent_EQUIP_RELIC_SET_NAME	{0}：
TextMapData_TextMapContent_EQUIP_RELIC_SET_NUM	{0}件套：
TextMapData_TextMapContent_EQUIP_RELIC_LEVEL_NOT_ENOUGH	武器等级不足，不能突破
TextMapData_TextMapContent_EQUIP_RELIC_BREAK_PROP_ADD	突破可增加一条新的追加属性
TextMapData_TextMapContent_EQUIP_RELIC_BREAK_PROP_IMPROVE	突破可随机提升任一追加属性
TextMapData_TextMapContent_EQUIP_RELIC_BREAK_MATERIAL_NOT_ENOUGH	{0}不足
TextMapData_TextMapContent_EQUIP_MAX_EXP_TIP	已达到最大经验，无法添加
TextMapData_TextMapContent_EQUIP_NO_FOOD_TIP	请选择升级材料
TextMapData_TextMapContent_EQUIP_LEVEL	Lv.{0}
TextMapData_TextMapContent_EQUIP_LEVEL_WITH_MAX	Lv.{0}<color=#FFFFFF9B> / {1}</color>
TextMapData_TextMapContent_EQUIP_SCREEN	筛选
TextMapData_TextMapContent_EQUIP_SCREEN_WITH_NAME	筛选 / {0}
TextMapData_TextMapContent_EQUIP_SCREEN_ALL	全部
TextMapData_TextMapContent_EQUIP_LEVELUP_SUCCESS	成功
TextMapData_TextMapContent_EQUIP_LEVELUP_SUPER_SUCCESS	两倍经验强化
TextMapData_TextMapContent_EQUIP_LEVELUP_SUPER_GREAT_SUCCESS	五倍经验强化！
TextMapData_TextMapContent_EQUIP_LEVELUP_SUCCESS_TIP	+{0}（×{1}）倍暴击强化！
TextMapData_TextMapContent_EQUIP_FAST_ADD_OVER_TIP	添加的材料中存在强力装备
TextMapData_TextMapContent_EQUIP_REPLACE_TIP	{0}已被{1}装备，是否更换？
TextMapData_TextMapContent_EQUIP_FAST_ADD_NO_FOOD_TIP	没有可用于消耗的物品
TextMapData_TextMapContent_EQUIP_AWAKEN_COUNT_USED_TIP	精炼提升次数 <color=#99FF88FF>{0}</color> / {1}
TextMapData_TextMapContent_EQUIP_AWAKEN_COUNT_UNUSE	还有剩余的精炼次数
TextMapData_TextMapContent_EQUIP_AWAKEN_FOOD_UNSELECT	未选择精炼材料
TextMapData_TextMapContent_EQUIP_AWAKEN_NEED_NOT_ENOUGH	{0}不足
TextMapData_TextMapContent_SORT_BY_LEVEL	等级顺序
TextMapData_TextMapContent_SORT_BY_COST	Cost顺序
TextMapData_TextMapContent_SORT_BY_QUALITY	品质顺序
TextMapData_TextMapContent_SORT_BY_EXP	基础经验顺序
TextMapData_TextMapContent_SORT_BY_ELEMENT	元素顺序
TextMapData_TextMapContent_INFO_MONSTER_SUPPRESS_STAGE_01	有强大怪物的气息，请多加注意
TextMapData_TextMapContent_INFO_MONSTER_SUPPRESS_STAGE_02	敌人的气息愈发凶险，还是返回为妙！
TextMapData_TextMapContent_TALENT_LOCK_COLOR	<color=#808080FF>{0}</color>
TextMapData_TextMapContent_TALENT_UNLOCK_COLOR	<color=#FFFFFFFF>{0}</color>
TextMapData_TextMapContent_TALENT_UNLOCK_NEED	需要{0}达到{1}级
TextMapData_TextMapContent_TALENT_DESCRIPTION	{0}级：{1}
TextMapData_TextMapContent_TALENT_BIG_TYPE	星辉天赋
TextMapData_TextMapContent_TALENT_SMALL_TYPE	星尘天赋
TextMapData_TextMapContent_TALENT_LEVEL_MAX	已经满级
TextMapData_TextMapContent_TALENT_AVATAR_LEVEL_NOT_ENOUGH	角色等级不够
TextMapData_TextMapContent_TALENT_AVATAR_BREAK_NOT_ENOUGH	角色突破等级不够
TextMapData_TextMapContent_TALENT_PRETALENT_UNLOCK	前置{0}没有激活
TextMapData_TextMapContent_TALENT_POINT_NOT_ENOUGH	{0}不足
TextMapData_TextMapContent_TALENT_POINT_SMALL_NAME	星尘
TextMapData_TextMapContent_TALENT_POINT_BIG_NAME	星辉
TextMapData_TextMapContent_TALENT_AVATAR_LEVEL_NEED	{0} Lv.{1}
TextMapData_TextMapContent_TALENT_CARD_TO_POINT_TIP	将消耗该道具转化为<color=#FFFFFF> <size=26>{0}</size> </color>点{1}
TextMapData_TextMapContent_TALENT_CARD_USE_NUM_LIMIT_TIP	已达到角色可使用的星尘/星辉上限
TextMapData_TextMapContent_AVATAR_TALENT_POINT_SMALL_CHANGE	{0}获得{1}点星尘点
TextMapData_TextMapContent_AVATAR_TALENT_POINT_BIG_CHANGE	{0}获得{1}点星辉点
TextMapData_TextMapContent_ITEM_NOT_ENOUGH_COLOR	<color=#FF5E41FF>{0}</color>
TextMapData_TextMapContent_ITEM_NEED_OF_CURRENT	{0}/{1}
TextMapData_TextMapContent_INFO_BORED_CREATE_MONSTER	<color=#FF5E41FF>警戒！精英怪物出现！</color>
TextMapData_TextMapContent_INFO_NEW_AVATAR	获得新角色: {0}
TextMapData_TextMapContent_INFO_NEW_ITEM	获得: {0}
TextMapData_TextMapContent_INFO_SYSTEM_NO_PATH	当前位置无法寻找到目标
TextMapData_TextMapContent_INFO_AVATAR_PROMOTE_BEYOND_TEAM_COST	角色突破后Cost将超出队伍消耗上限，可尝试先离队再突破
TextMapData_TextMapContent_INFO_AVATAR_PROMOTE_MATERIAL_NOT_ENOUGH	突破材料不够！
TextMapData_TextMapContent_INFO_NAME_IS_TOO_SHORT	名字不能小于{0}个字
TextMapData_TextMapContent_INFO_NAME_IS_TOO_LONG	名字不能超过{0}个字
TextMapData_TextMapContent_INFO_NAME_HAS_INVALID_CHAR	名字中不能包含{0}
TextMapData_TextMapContent_INFO_NAME_SPACE	空格
TextMapData_TextMapContent_INFO_QUEST_INTERACT_FAIL_FIGHT	战斗中无法进行任务对话
TextMapData_TextMapContent_EQUIP_AFFIX_LEVEL0	Lv1
TextMapData_TextMapContent_EQUIP_AFFIX_LEVEL1	Lv2
TextMapData_TextMapContent_EQUIP_AFFIX_LEVEL2	Lv3
TextMapData_TextMapContent_EQUIP_AFFIX_LEVEL3	Lv4
TextMapData_TextMapContent_EQUIP_AFFIX_LEVEL4	Lv5
TextMapData_TextMapContent_INFO_FOOD_BUFF	成功使用{0}，{1}{2}
TextMapData_TextMapContent_INFO_Item_Food_RecoverHP	将在一段时间内恢复生命值
TextMapData_TextMapContent_INFO_Item_Food_RecoverInstantHP	将立即恢复部分生命值
TextMapData_TextMapContent_INFO_Item_Food_Attack	将在一段时间内提升攻击力
TextMapData_TextMapContent_INFO_Item_Food_MoveSpeed	将在一段时间内提升移动速度
TextMapData_TextMapContent_INFO_Item_Food_Defence	将在一段时间内提升防御力
TextMapData_TextMapContent_CONTROL_MOVE_FORWARD	向前移动
TextMapData_TextMapContent_CONTROL_MOVE_BACKWARD	向后移动
TextMapData_TextMapContent_CONTROL_MOVE_LEFT	向左移动
TextMapData_TextMapContent_CONTROL_MOVE_RIGHT	向右移动
TextMapData_TextMapContent_CONTROL_SKILL1	普通攻击
TextMapData_TextMapContent_CONTROL_SKILL2	元素战技
TextMapData_TextMapContent_CONTROL_SPRINT_OR_SKILL3	冲刺
TextMapData_TextMapContent_CONTROL_JUMP_OR_SKILL4	跳跃
TextMapData_TextMapContent_CONTROL_SKILL5	元素爆发
TextMapData_TextMapContent_CONTROL_OPEN_BAG	打开背包
TextMapData_TextMapContent_CONTROL_OPEN_CHARACTER	打开角色界面
TextMapData_TextMapContent_CONTROL_OPEN_MAP	打开地图
TextMapData_TextMapContent_CONTROL_OPEN_PAIMEN	打开派蒙界面
TextMapData_TextMapContent_CONTROL_TOGGLE_QUEST_BOOK	开关任务菜单
TextMapData_TextMapContent_CONTROL_TO_AVATAR1	切换小队角色1
TextMapData_TextMapContent_CONTROL_TO_AVATAR2	切换小队角色2
TextMapData_TextMapContent_CONTROL_TO_AVATAR3	切换小队角色3
TextMapData_TextMapContent_CONTROL_TO_AVATAR4	切换小队角色4
TextMapData_TextMapContent_CONTROL_TO_AVATAR1_TRIGGER_SKILL	切换到小队角色1并使用其元素爆发
TextMapData_TextMapContent_CONTROL_TO_AVATAR2_TRIGGER_SKILL	切换到小队角色2并使用其元素爆发
TextMapData_TextMapContent_CONTROL_TO_AVATAR3_TRIGGER_SKILL	切换到小队角色3并使用其元素爆发
TextMapData_TextMapContent_CONTROL_TO_AVATAR4_TRIGGER_SKILL	切换到小队角色4并使用其元素爆发
TextMapData_TextMapContent_CONTROL_TOGGLE_ATTACK_MODE	切换瞄准模式
TextMapData_TextMapContent_CONTROL_PICK_TALK	拾取/对话
TextMapData_TextMapContent_CONTROL_MOVE	移动角色
TextMapData_TextMapContent_CONTROL_VIEW	转动视角
TextMapData_TextMapContent_CONTROL_CHANGE_AVATAR_TRIGGER	呼出换人轮盘
TextMapData_TextMapContent_CONTROL_ELEMENT_VIEW	长按打开元素视野
TextMapData_TextMapContent_CONTROL_HELP	打开提示页面
TextMapData_TextMapContent_CONTROL_SLOW_MOVE	切换走/跑
TextMapData_TextMapContent_KeyCode_Alpha1	1
TextMapData_TextMapContent_KeyCode_Alpha2	2
TextMapData_TextMapContent_KeyCode_Alpha3	3
TextMapData_TextMapContent_KeyCode_Alpha4	4
TextMapData_TextMapContent_KeyCode_Escape	Esc
TextMapData_TextMapContent_KeyCode_LeftControl	左Ctrl
TextMapData_TextMapContent_KeyCode_LeftAlt	左Alt
TextMapData_TextMapContent_KeyCode_LeftShift	左Shift
TextMapData_TextMapContent_KeyCode_Mouse0	鼠标左键
TextMapData_TextMapContent_KeyCode_Mouse1	鼠标右键
TextMapData_TextMapContent_KeyCode_Mouse2	鼠标中键
TextMapData_TextMapContent_NEW_AVATAR_GET_TIP	获得 {0}
TextMapData_TextMapContent_EQUIP_RANK_LEVEL1	
TextMapData_TextMapContent_EQUIP_RANK_LEVEL2	
TextMapData_TextMapContent_EQUIP_RANK_LEVEL3	
TextMapData_TextMapContent_EQUIP_RANK_LEVEL4	
TextMapData_TextMapContent_EQUIP_RANK_LEVEL5	
TextMapData_TextMapContent_UI_REPAIR_SKYHARP_PAGE_RESULT_ONE	天空之琴似乎有种青春焕发的感觉
TextMapData_TextMapContent_UI_REPAIR_SKYHARP_PAGE_RESULT_TWO	天空之琴和原先的感觉完全不一样了，周围的风元素似乎在躁动
TextMapData_TextMapContent_COOK_COOK	料理制作
TextMapData_TextMapContent_COOK_COMPOUND	食材加工
TextMapData_TextMapContent_COOK_RANDOM_COOK	乱炖
TextMapData_TextMapContent_COOK_FOOD_MEAT	卫士料理
TextMapData_TextMapContent_COOK_FOOD_FRUIT	勇者料理
TextMapData_TextMapContent_COOK_FOOD_STAPLE	冒险家料理
TextMapData_TextMapContent_COOK_FOOD_SWEET	贤者料理
TextMapData_TextMapContent_COOKING_PAGE_HAVE_NUM	已持有：{0}
TextMapData_TextMapContent_COOKING_PAGE_COMPOUND_QUEUE_SIZE	队列上限：{0}
TextMapData_TextMapContent_COOKING_PAGE_NOT_ENOUGH_TIP	材料不足（有些原料可以去城里的餐馆碰碰运气哦）
TextMapData_TextMapContent_COOKING_ITEM_PROFICIENCY	熟练度 {0}/{1}
TextMapData_TextMapContent_COOKING_ITEM_COOK_NEED	烹饪材料
TextMapData_TextMapContent_COOKING_ITEM_COMPOUND_NEED	加工原料
TextMapData_TextMapContent_COOKING_ITEM_COMPOUND_TIME	制作耗时 {0:F1} 分钟
TextMapData_TextMapContent_COOKING_NEED_FIRE	请先点火
TextMapData_TextMapContent_COOKING_QTE_ITEM_QUALITY1	完成
TextMapData_TextMapContent_COOKING_QTE_ITEM_QUALITY2	成功
TextMapData_TextMapContent_COOKING_QTE_ITEM_QUALITY3	完美
TextMapData_TextMapContent_COOKING_QTE_NO_BONUS_DESC	该角色暂无加成
TextMapData_TextMapContent_COOKING_COMPOUND_QUEUE_MAX	队列已满
TextMapData_TextMapContent_COOKING_COMPOUND_CURRENT_COUNT	<color=#FFFFFFFF>{0}/{1}</color>
TextMapData_TextMapContent_COOKING_AVATAR_SELECT_CURRENT	{0} <color=#FFCC33FF><size=20>/ 当前</size></color>
TextMapData_TextMapContent_COOK_BONUS_REPLACE	有概率获得特殊料理
TextMapData_TextMapContent_COOK_BONUS_PROFICIENCY	熟练度获取加倍
TextMapData_TextMapContent_MAIL_ITEM_NOT_RECEIVE_TIP	附件未领取
TextMapData_TextMapContent_MAIL_CONFIRM_DELETE_TIP	确认删除？
TextMapData_TextMapContent_MAIL_CONFIRM_DELETE_IMPORTANCE_TIP	有重要邮件，确认删除？
TextMapData_TextMapContent_MAIL_DETAIL_SENDER	发件人：{0}
TextMapData_TextMapContent_MAIL_DETAIL_DATE	时间：{0}
TextMapData_TextMapContent_MAIL_MAX_NUM_TIP	收件箱最多保存 1000封 邮件，\n超出时自动删除无附件或附件已领取的旧邮件
TextMapData_TextMapContent_MAIL_NO_ITEM_GET_ALL_TIP	您的邮箱内附件已全部领取完毕
TextMapData_TextMapContent_MAIL_OVER_TIME_SECOND	刚刚
TextMapData_TextMapContent_MAIL_OVER_TIME_MINUTE	{0}分钟
TextMapData_TextMapContent_MAIL_OVER_TIME_HOUR	{0}小时
TextMapData_TextMapContent_MAIL_OVER_TIME_DAY	{0}天
TextMapData_TextMapContent_MAIL_EXPIRE_TIME_DAY	{0}天后过期
TextMapData_TextMapContent_ITEM_TIP_PLAYER_LEVEL_ITEM	需求冒险等阶{0}
TextMapData_TextMapContent_ITEM_TIP_PLAYER_LEVEL_EQUIP	需求冒险等阶{0}
TextMapData_TextMapContent_EQUIP_CHANGE_TIP_PLAYER_LEVEL	需求冒险等阶{0}
TextMapData_TextMapContent_EQUIP_PLAYER_LEVEL_NOT_ENOUGH_TIP	冒险等阶不足，无法装备
TextMapData_TextMapContent_ITEM_PLAYER_LEVEL_NOT_ENOUGH_TIP	冒险等阶不足，无法使用
TextMapData_TextMapContent_ITEM_SLOT_COUNT_DOWN_SECOND	{0}秒
TextMapData_TextMapContent_ITEM_SLOT_COUNT_DOWN_MINUTE	{0}分钟
TextMapData_TextMapContent_ITEM_SLOT_COUNT_DOWN_HOUR	{0}小时
TextMapData_TextMapContent_ITEM_GOT_DIALOG_REASON_MAIL	邮件附件
TextMapData_TextMapContent_FETCH_BUTTON_HINT	已完成{0}个
TextMapData_TextMapContent_COUNT_SELECT_DIALOG_COMPOUND	选择加工数量
TextMapData_TextMapContent_PLAYER_MAX_STAMINA_CHANGE	体力上限提升{0}→{1}
TextMapData_TextMapContent_OPEN_STATE_AVATAR_PROMOTE	角色突破
TextMapData_TextMapContent_OPEN_STATE_AVATAR_TALENT	角色天赋
TextMapData_TextMapContent_OPEN_STATE_WEAPON_PROMOTE	武器突破
TextMapData_TextMapContent_OPEN_STATE_WEAPON_AWAKEN	武器精炼
TextMapData_TextMapContent_OPEN_STATE_WEAPON_UPGRADE	武器强化
TextMapData_TextMapContent_OPEN_STATE_RELIQUARY_PROMOTE	圣遗物突破
TextMapData_TextMapContent_OPEN_STATE_RELIQUARY_UPGRADE	圣遗物强化
TextMapData_TextMapContent_OPEN_STATE_CHANGE_TIP_OPEN	{0}功能开启
TextMapData_TextMapContent_OPEN_STATE_CLOSE_TIP	暂未开启
TextMapData_TextMapContent_OPEN_STATE_CLOSE_TIP_LEVEL	开启条件：冒险等阶{0}级
TextMapData_TextMapContent_OPEN_STATE_CLOSE_TIP_QUEST	开启条件：完成任务{0}
TextMapData_TextMapContent_PAGE_TITLE_SEPARATOR	{0} /
TextMapData_TextMapContent_COST_TEXT_MAP_VALUE	Cost
TextMapData_TextMapContent_ITEM_NOT_ENOUGH_COMMON_TIP	{0}不足
TextMapData_TextMapContent_PROP_CHANGE_ADD_TIP	{0}增加{1}
TextMapData_TextMapContent_PROP_CHANGE_REDUCE_TIP	{0}减少{1}
TextMapData_TextMapContent_DUNGEON_MUTIPLAYER_HOST_DIALOG_TIP	当前处于联机状态，进入单人副本需要踢出所有队员，是否继续？
TextMapData_TextMapContent_DUNGEON_MUTIPLAYER_HOST_OK_BUTTON	踢出队员
TextMapData_TextMapContent_DUNGEON_MUTIPLAYER_HOST_CANCEL_BUTTON	放弃进入
TextMapData_TextMapContent_RET_JOIN_OTHER_WAIT	正在准备联机，请等待
TextMapData_TextMapContent_GENERAL_PROMPT_DIALOG_NEW_MAIL_TIP	新的邮件
TextMapData_TextMapContent_REWARD_ITEM_GOT_TIP	{0} <color=#FFFFFF80><size=14>×</size></color> {1}
TextMapData_TextMapContent_SHOP_ITEM_REFRESH_FORMAT	yyyy/MM/dd HH:mm
TextMapData_TextMapContent_COMMON_ITEM_COUNT_FORMAT	{0}×{1}
TextMapData_TextMapContent_QUEST_DIALOG_SELECT_PLAYER_LEVEL_NEED	需要冒险等阶{0}
TextMapData_TextMapContent_QUEST_DIALOG_DETAIL_PLAYER_LEVEL_NEED	将冒险等阶提升至{0}开启
TextMapData_TextMapContent_CHAPTER_COMPLETE_DIALOG_TITLE	{0} 完成
TextMapData_TextMapContent_CHAPTER_NOTICE_DIALOG_TITLE	{0} {1}\n在<color=#FFFFFFFF>冒险等阶{2}</color>后开启
TextMapData_TextMapContent_LOADING_DIALOG_TIPS	本次测试为第一次删档测试，不代表游戏最终品质
TextMapData_TextMapContent_LANGUAGE_NAME_SC	简体中文
TextMapData_TextMapContent_LANGUAGE_NAME_TC	繁體中文
TextMapData_TextMapContent_LANGUAGE_NAME_EN	English
TextMapData_TextMapContent_LANGUAGE_NAME_FR	Français
TextMapData_TextMapContent_LANGUAGE_NAME_DE	Deutsch
TextMapData_TextMapContent_LANGUAGE_NAME_ES	Español
TextMapData_TextMapContent_LANGUAGE_NAME_PT	Português
TextMapData_TextMapContent_LANGUAGE_NAME_RU	Русский язык
TextMapData_TextMapContent_LANGUAGE_NAME_JP	日本語
TextMapData_TextMapContent_LANGUAGE_NAME_KR	한국어
TextMapData_TextMapContent_LANGUAGE_NAME_TH	ภาษาไทย
TextMapData_TextMapContent_LANGUAGE_NAME_VN	Tiếng Việt
TextMapData_TextMapContent_LANGUAGE_NAME_ID	Bahasa Indonesia
TextMapData_TextMapContent_SHOP_TYPE_PAIMON	内测商店
TextMapData_TextMapContent_SHOP_TYPE_CITY	纪念品商店
TextMapData_TextMapContent_SHOP_TYPE_BLACKSMITH	铁匠铺
TextMapData_TextMapContent_SHOP_TYPE_GROCERY	杂货店
TextMapData_TextMapContent_SHOP_TYPE_FOOD	餐馆
TextMapRetData_TextMapContent_RET_FAIL	失败
TextMapRetData_TextMapContent_RET_SVR_ERROR	服务器内部错误
TextMapRetData_TextMapContent_RET_UNKNOWN_ERROR	未知错误
TextMapRetData_TextMapContent_RET_FREQUENT	请求过于频繁
TextMapRetData_TextMapContent_RET_STOP_REGISTER	您的账号没有测试资格，无法进入游戏。
TextMapRetData_TextMapContent_RET_STOP_SERVER	停服维护中
TextMapRetData_TextMapContent_RET_ACCOUNT_VEIRFY_ERROR	账号验证失败
TextMapRetData_TextMapContent_RET_ACCOUNT_FREEZE	账号冻结
TextMapRetData_TextMapContent_RET_REPEAT_LOGIN	重复登陆
TextMapRetData_TextMapContent_RET_CLIENT_VERSION_ERROR	客户端版本号错误
TextMapRetData_TextMapContent_RET_TOKEN_ERROR	token错误
TextMapRetData_TextMapContent_RET_ACCOUNT_NOT_EXIST	账号不存在
TextMapRetData_TextMapContent_RET_WAIT_OTHER_LOGIN	等待其他设备完成登入
TextMapRetData_TextMapContent_RET_ANOTHER_LOGIN	被其他登入流程打断
TextMapRetData_TextMapContent_RET_CLIENT_FORCE_UPDATE	客户端版本太低
TextMapRetData_TextMapContent_RET_BLACK_UID	您的账号已被封禁，无法进入游戏。
TextMapRetData_TextMapContent_RET_LOGIN_DB_FAIL	数据库读取失败
TextMapRetData_TextMapContent_RET_LOGIN_INIT_FAIL	初始化数据失败
TextMapRetData_TextMapContent_RET_LOGIN_MAX_PLAYER	服务器繁忙，请稍后再试
TextMapRetData_TextMapContent_RET_AVATAR_IN_CD	角色切换正在冷却中
TextMapRetData_TextMapContent_RET_AVATAR_NOT_ALIVE	角色无法继续战斗
TextMapRetData_TextMapContent_RET_AVATAR_NOT_ON_SCENE	角色不在地图上
TextMapRetData_TextMapContent_RET_CAN_NOT_FIND_AVATAR	无法找到该角色
TextMapRetData_TextMapContent_RET_CAN_NOT_DEL_CUR_AVATAR	不能删除当前的角色
TextMapRetData_TextMapContent_RET_DUPLICATE_AVATAR	角色重复
TextMapRetData_TextMapContent_RET_AVATAR_IS_SAME_ONE	目标角色与当前角色相同
TextMapRetData_TextMapContent_RET_AVATAR_LEVEL_LESS_THAN	角色等级不足
TextMapRetData_TextMapContent_RET_AVATAR_CAN_NOT_CHANGE_ELEMENT	角色不能改变元素类型
TextMapRetData_TextMapContent_RET_AVATAR_BREAK_LEVEL_LESS_THAN	角色突破等级不够
TextMapRetData_TextMapContent_RET_AVATAR_ON_MAX_BREAK_LEVEL	角色已是最大突破等级
TextMapRetData_TextMapContent_RET_AVATAR_ID_ALREADY_EXIST	相同ID的角色已存在
TextMapRetData_TextMapContent_RET_AVATAR_NOT_DEAD	角色不是死亡状态
TextMapRetData_TextMapContent_RET_AVATAR_IS_REVIVING	角色在复活中
TextMapRetData_TextMapContent_RET_AVATAR_ID_ERROR	角色ID出错
TextMapRetData_TextMapContent_RET_REPEAT_SET_PLAYER_BORN_DATA	无法重复设置玩家出生数据
TextMapRetData_TextMapContent_RET_CAN_NOT_FIND_TEAM	找不到队伍
TextMapRetData_TextMapContent_RET_CAN_NOT_FIND_CUR_TEAM	找不到当前的队伍
TextMapRetData_TextMapContent_RET_AVATAR_NOT_EXIST_IN_TEAM	角色不在当前队伍中
TextMapRetData_TextMapContent_RET_CAN_NOT_REMOVE_CUR_AVATAR_FROM_TEAM	不能将当前的角色从队伍中删除
TextMapRetData_TextMapContent_RET_CAN_NOT_USE_REVIVE_ITEM_FOR_CUR_AVATAR	不能对出战角色使用复活道具
TextMapRetData_TextMapContent_RET_TEAM_COST_EXCEED_LIMIT	队伍COST超过上限
TextMapRetData_TextMapContent_RET_NICKNAME_UTF8_ERROR	昵称不是有效的utf8字符串
TextMapRetData_TextMapContent_RET_NICKNAME_TOO_LONG	昵称太长
TextMapRetData_TextMapContent_RET_NICKNAME_WORD_ILLEGAL	昵称含有非法单词
TextMapRetData_TextMapContent_RET_OPEN_STATE_NOT_OPEN	功能暂未开放
TextMapRetData_TextMapContent_RET_NPC_NOT_EXIST	NPC不存在
TextMapRetData_TextMapContent_RET_NPC_TOO_FAR	NPC距离太远
TextMapRetData_TextMapContent_RET_NOT_CURRENT_TALK	不是当前对话
TextMapRetData_TextMapContent_RET_NPC_CREATE_FAIL	NPC移动失败
TextMapRetData_TextMapContent_RET_NPC_MOVE_FAIL	NPC创建失败
TextMapRetData_TextMapContent_RET_QUEST_NOT_EXIST	任务不存在
TextMapRetData_TextMapContent_RET_QUEST_IS_FAIL	任务已失败
TextMapRetData_TextMapContent_RET_QUEST_CONTENT_ERROR	任务内容错误
TextMapRetData_TextMapContent_RET_POINT_NOT_UNLOCKED	传送点未解锁
TextMapRetData_TextMapContent_RET_POINT_TOO_FAR	传送点距离太远
TextMapRetData_TextMapContent_RET_POINT_ALREAY_UNLOCKED	传送点已解锁
TextMapRetData_TextMapContent_RET_ENTITY_NOT_EXIST	 
TextMapRetData_TextMapContent_RET_ENTER_SCENE_FAIL	进入场景失败
TextMapRetData_TextMapContent_RET_PLAYER_IS_ENTER_SCENE	正在进入场景中
TextMapRetData_TextMapContent_RET_AREA_MAX_LEVEL	区域已经达到最高等级
TextMapRetData_TextMapContent_RET_AREA_LOCKED	区域尚未解锁
TextMapRetData_TextMapContent_RET_ITEM_NOT_EXIST	道具不存在
TextMapRetData_TextMapContent_RET_PACK_EXCEED_MAX_WEIGHT	背包超出最大重量
TextMapRetData_TextMapContent_RET_ITEM_NOT_DROPABLE	道具不可丢弃
TextMapRetData_TextMapContent_RET_ITEM_NOT_USABLE	道具不可使用
TextMapRetData_TextMapContent_RET_ITEM_INVALID_USE_COUNT	道具使用数量非法
TextMapRetData_TextMapContent_RET_ITEM_INVALID_DROP_COUNT	道具丢弃数量非法
TextMapRetData_TextMapContent_RET_ITEM_ALREADY_EXIST	道具已经存在
TextMapRetData_TextMapContent_RET_ITEM_IN_COOLDOWN	道具使用在冷却中
TextMapRetData_TextMapContent_RET_ITEM_COUNT_NOT_ENOUGH	道具数量不够
TextMapRetData_TextMapContent_RET_ITEM_INVALID_TARGET	目标无效
TextMapRetData_TextMapContent_RET_RECIPE_NOT_EXIST	食谱不存在
TextMapRetData_TextMapContent_RET_RECIPE_LOCKED	食谱尚未解锁
TextMapRetData_TextMapContent_RET_RECIPE_UNLOCKED	食谱已经解锁
TextMapRetData_TextMapContent_RET_COMPOUND_QUEUE_FULL	加工队列已满
TextMapRetData_TextMapContent_RET_COMPOUND_NOT_FINISH	加工尚未完成
TextMapRetData_TextMapContent_RET_MAIL_ITEM_NOT_GET	邮件附件未领取
TextMapRetData_TextMapContent_RET_ITEM_EXCEED_LIMIT	道具数量超过上限
TextMapRetData_TextMapContent_RET_AVATAR_CAN_NOT_USE	尚未获得该角色，无法使用此道具
TextMapRetData_TextMapContent_RET_ITEM_NEED_PLAYER_LEVEL	冒险等阶不足，不能使用
TextMapRetData_TextMapContent_RET_RECIPE_NOT_AUTO_QTE	未达到熟练度上限，食谱无法自动烹饪
TextMapRetData_TextMapContent_RET_COMPOUND_BUSY_QUEUE	加工系统没有空闲的生产线
TextMapRetData_TextMapContent_RET_EQUIP_LEVEL_HIGHER	装备所需等级高于角色
TextMapRetData_TextMapContent_RET_EQUIP_CAN_NOT_WAKE_OFF_WEAPON	不能脱下武器
TextMapRetData_TextMapContent_RET_EQUIP_HAS_BEEN_WEARED	装备已经被穿戴
TextMapRetData_TextMapContent_RET_EQUIP_WEARED_CANNOT_DROP	装备中无法丢弃
TextMapRetData_TextMapContent_RET_GOODS_NOT_EXIST	商品不存在
TextMapRetData_TextMapContent_RET_GOODS_MATERIAL_NOT_ENOUGH	消耗材料不足
TextMapRetData_TextMapContent_RET_GADGET_NOT_EXIST	物件不存在
TextMapRetData_TextMapContent_RET_GADGET_NOT_INTERACTIVE	物件不可交互
TextMapRetData_TextMapContent_RET_GADGET_NOT_GATHERABLE	物件不可采集
TextMapRetData_TextMapContent_RET_CHEST_IS_LOCKED	宝箱被锁住
TextMapRetData_TextMapContent_RET_GADGET_CREATE_FAIL	物件创建失败
TextMapRetData_TextMapContent_RET_WORKTOP_OPTION_NOT_EXIST	操作台选项不存在
TextMapRetData_TextMapContent_RET_TALENT_ALREAY_UNLOCKED	天赋已解锁
TextMapRetData_TextMapContent_RET_PREV_TALENT_NOT_UNLOCKED	前置天赋未解锁
TextMapRetData_TextMapContent_RET_BIG_TALENT_POINT_NOT_ENOUGH	星辉不足
TextMapRetData_TextMapContent_RET_SMALL_TALENT_POINT_NOT_ENOUGH	星尘不足
TextMapRetData_TextMapContent_RET_NEED_MORE_SCOIN	摩拉不足
TextMapRetData_TextMapContent_RET_SKILL_DEPOT_NOT_FOUND	找不到技能库
TextMapRetData_TextMapContent_RET_HCOIN_NOT_ENOUGH	原石不足
TextMapRetData_TextMapContent_RET_SCOIN_NOT_ENOUGH	摩拉不足
TextMapRetData_TextMapContent_RET_HCOIN_EXCEED_LIMIT	原石超过最大数量
TextMapRetData_TextMapContent_RET_SCOIN_EXCEED_LIMIT	摩拉超过最大数量
TextMapRetData_TextMapContent_RET_MAIL_EXPIRED	过期邮件无法领取，并会被删除
TextMapRetData_TextMapContent_RET_CANDIDATE_SKILL_DEPOT_ID_NOT_FIND	找不到候选技能库
TextMapRetData_TextMapContent_RET_SKILL_DEPOT_IS_THE_SAME	技能库ID相同
TextMapRetData_TextMapContent_RET_MONSTER_NOT_EXIST	怪物不存在
TextMapRetData_TextMapContent_RET_MONSTER_CREATE_FAIL	创建怪物失败
TextMapRetData_TextMapContent_RET_DUNGEON_ENTER_FAIL	副本进入失败
TextMapRetData_TextMapContent_RET_DUNGEON_QUIT_FAIL	副本退出失败
TextMapRetData_TextMapContent_RET_DUNGEON_ENTER_EXCEED_DAY_COUNT	已达本日最大副本进入次数
TextMapRetData_TextMapContent_RET_DUNGEON_REVIVE_EXCEED_MAX_COUNT	已达副本最大复活次数
TextMapRetData_TextMapContent_RET_DUNGEON_REVIVE_FAIL	副本复活失败
TextMapRetData_TextMapContent_RET_DUNGEON_NOT_SUCCEED	副本未成功
TextMapRetData_TextMapContent_RET_DUNGEON_CAN_NOT_CANCEL	副本不可取消
TextMapRetData_TextMapContent_RET_MP_NOT_IN_MY_WORLD	身处他人世界，无法进行该操作
TextMapRetData_TextMapContent_RET_MP_IN_MP_MODE	联机模式中，无法进行该操作
TextMapRetData_TextMapContent_RET_MP_SCENE_IS_FULL	联机玩家数已达最大，无法加入
TextMapRetData_TextMapContent_RET_MP_MODE_NOT_AVAILABLE	目标不能进入联机状态
TextMapRetData_TextMapContent_RET_MP_PLAYER_NOT_ENTERABLE	玩家无法加入
TextMapRetData_TextMapContent_RET_MP_QUEST_BLOCK_MP	特定任务未完成，不能进入他人世界
TextMapRetData_TextMapContent_RET_MP_IN_ROOM_SCENE 	身处房间中，不能进入他人世界
TextMapRetData_TextMapContent_RET_MAIL_PARA_ERR	邮件请求格式错误
TextMapRetData_TextMapContent_RET_MAIL_MAX_NUM	邮件数量已满
TextMapRetData_TextMapContent_RET_MAIL_ITEM_NUM_EXCEED	邮件附件数量过多
TextMapRetData_TextMapContent_RET_MAIL_TITLE_LEN_EXCEED	邮件标题长度超出限制
TextMapRetData_TextMapContent_RET_MAIL_CONTENT_LEN_EXCEED	邮件正文长度超出限制
TextMapRetData_TextMapContent_RET_MAIL_SENDER_LEN_EXCEED	邮件发件人长度超出限制
TextMapMsgData_TextMapContent_MSG_UNKNOWN	未知错误
TextMapMsgData_TextMapContent_ENET_TIMEOUT	连接超时
TextMapMsgData_TextMapContent_ENET_SERVER_RELOGIN	账号在另一处重复登录
TextMapMsgData_TextMapContent_ENET_SERVER_KICK	被服务器踢下线
TextMapMsgData_TextMapContent_ENET_SERVER_SHUTDOWN	服务器正在重启中
TextMapMsgData_TextMapContent_ENET_NOT_FOUND_SESSION	与服务器的连接不存在
TextMapMsgData_TextMapContent_ENET_LOGIN_UNFINISHED	登录未完成
TextMapMsgData_TextMapContent_ENET_PACKET_FREQ_TOO_HIGH	客户端发包太频繁，连接断开
TextMapMsgData_TextMapContent_ENET_PING_TIMEOUT	与服务器的心跳超时
TextMapMsgData_TextMapContent_ENET_TRANFER_FAILED	迁移失败，客户端重连
TextMapMsgData_TextMapContent_ENET_QUIT_MP	退出联机，断线重连
TextMapMsgData_TextMapContent_MSG_BLOCK_REFRESH_COUNTDOWN	怪物即将刷新
TextMapMsgData_TextMapContent_MSG_AVATAR_REVIVE_BY_STATUE	在神像的恩泽下，{0}得到了治疗