ID	文本
TextMapUIStcData_TextMapContent_UI_STC_GAMEENTRYPAGE_CONTINUE_TEXT	C<size=40>ONTINUE</size>
TextMapUIStcData_TextMapContent_UI_STC_GAMEENTRYPAGE_CONTINUE_LABEL	继续冒险
TextMapUIStcData_TextMapContent_UI_STC_GAMEENTRYPAGE_CONTINUE_TIPS	继续之前的游戏
TextMapUIStcData_TextMapContent_UI_STC_GAMEENTRYPAGE_NEWGAME_TEXT	N<size=40>EW</size> G<size=40>AME</size>
TextMapUIStcData_TextMapContent_UI_STC_GAMEENTRYPAGE_NEWGAME_LABEL	新游戏
TextMapUIStcData_TextMapContent_UI_STC_GAMEENTRYPAGE_NEWGAME_TIPS	开始新的游戏
TextMapUIStcData_TextMapContent_UI_STC_GAMEENTRYPAGE_GALLERY_TEXT	G<size=40>ALLERY</size>
TextMapUIStcData_TextMapContent_UI_STC_GAMEENTRYPAGE_GALLERY_LABEL	画廊
TextMapUIStcData_TextMapContent_UI_STC_GAMEENTRYPAGE_GALLERY_TIPS	艺术设定
TextMapUIStcData_TextMapContent_UI_STC_GAMEENTRYPAGE_EXIT_TEXT	E<size=40>XIT</size>
TextMapUIStcData_TextMapContent_UI_STC_GAMEENTRYPAGE_EXIT_LABEL	离开
TextMapUIStcData_TextMapContent_UI_STC_GAMEENTRYPAGE_EXIT_TIPS	退出游戏
TextMapUIStcData_TextMapContent_UI_STC_GAMEENTRYPAGE_OPTION	设置
TextMapUIStcData_TextMapContent_UI_STC_GAMEENTRYPAGE_PLAYER	角色
TextMapUIStcData_TextMapContent_UI_STC_GAMEENTRYPAGE_SHOP	内测商店
TextMapUIStcData_TextMapContent_UI_STC_GAMEENTRYPAGE_TIME	时间
TextMapUIStcData_TextMapContent_UI_STC_GAMEENTRYPAGE_FEEDBACK	反馈
TextMapUIStcData_TextMapContent_UI_STC_GAMEENTRYPAGE_BULLETIN	公告
TextMapUIStcData_TextMapContent_UI_STC_GAMEENTRYPAGE_HANDBOOK	指南
TextMapUIStcData_TextMapContent_UI_STC_GAMEENTRYPAGE_MAINMENU	M<size=40>AIN</size> M<size=40>ENU</size>
TextMapUIStcData_TextMapContent_UI_STC_GAMEENTRYPAGE_LEVEL	LEVEL
TextMapUIStcData_TextMapContent_UI_STC_SHOPPAGE_NEED_MATERIALS	所需材料
TextMapUIStcData_TextMapContent_UI_STC_BAGPAGE_BAG	背包
TextMapUIStcData_TextMapContent_UI_STC_BAGPAGE_WEIGHT	负重
TextMapUIStcData_TextMapContent_UI_STC_BAGPAGE_DROP_TITLE	丢弃
TextMapUIStcData_TextMapContent_UI_STC_BAGPAGE_DROP_WARNING	确认要将{0}丢弃吗？
TextMapUIStcData_TextMapContent_UI_STC_CHARACTERPAGE_WEAPON	武器
TextMapUIStcData_TextMapContent_UI_STC_CHARACTERPAGE_RELIC	圣遗物
TextMapUIStcData_TextMapContent_UI_STC_CHARACTERPAGE_SKILL	技能
TextMapUIStcData_TextMapContent_UI_STC_CHARACTERPAGE_BACK	返回
TextMapUIStcData_TextMapContent_UI_STC_CHARACTERPAGE_COST	队伍消耗
TextMapUIStcData_TextMapContent_UI_STC_CHARACTER_PAGE_AVATAR	属性
TextMapUIStcData_TextMapContent_UI_STC_CHARACTER_PAGE_LEVEL_UP	升级
TextMapUIStcData_TextMapContent_UI_STC_CHARACTER_PAGE_STAR_UP	突破
TextMapUIStcData_TextMapContent_UI_STC_CHARACTER_PAGE_MAX_EXP	等级已到当前上限
TextMapUIStcData_TextMapContent_UI_STC_CHARACTER_PAGE_LEVEL_NOT_ENOUGH	尚未到达突破等级
TextMapUIStcData_TextMapContent_UI_STC_USEMATERIALDIALOG_USENUM	使用数量
TextMapUIStcData_TextMapContent_UI_STC_USEMATERIALDIALOG_DROPLINK	获取
TextMapUIStcData_TextMapContent_UI_STC_USEMATERIALDIALOG_NOITEM	无可用经验升级道具
TextMapUIStcData_TextMapContent_UI_STC_MAP_SCENE_EXPLORE	探索度
TextMapUIStcData_TextMapContent_UI_STC_MAP_AREA_LOCKED	未解锁
TextMapUIStcData_TextMapContent_UI_STC_MAP_AREA_UNLOCKED	已解锁
TextMapUIStcData_TextMapContent_UI_STC_LEVELUP_DIALOG_TITLE	升级
TextMapUIStcData_TextMapContent_UI_STC_LEVELUP_DIALOG_OK	确认
TextMapUIStcData_TextMapContent_UI_STC_STARUP_DIALOG_TITLE	突破
TextMapUIStcData_TextMapContent_UI_STC_STARUP_DIALOG_PROPERTY_CHANGE	属性变更
TextMapUIStcData_TextMapContent_UI_STC_STARUP_DIALOG_NEED_MATERIAL	所需材料
TextMapUIStcData_TextMapContent_UI_STC_AWAKENUP_DIALOG_TITLE	精炼
TextMapUIStcData_TextMapContent_UI_STC_CHARACTERPAGE_TALENT	天赋
TextMapUIStcData_TextMapContent_UI_STC_TALENT_LOCKED	<color=#FF5E41FF>天赋暂无</color>
TextMapUIStcData_TextMapContent_UI_STC_LOGOUT	退出登录
TextMapUIStcData_TextMapContent_UI_STC_BAG_NOITEM_TIP1	没有任何道具
TextMapUIStcData_TextMapContent_UI_STC_BAG_NOITEM_TIP2	这里空空如也
TextMapUIStcData_TextMapContent_UI_STC_DUNGEONENTRYPAGE_DungeonEntry	地下城入口
TextMapUIStcData_TextMapContent_UI_STC_DUNGEONENTRYPAGE_PossibleReward	可能获得奖励
TextMapUIStcData_TextMapContent_UI_STC_DUNGEONENTRYPAGE_FPReward	首次通关奖励
TextMapUIStcData_TextMapContent_UI_STC_DUNGEONENTRYPAGE_LevelUnsuitable	当前等级略微偏低
TextMapUIStcData_TextMapContent_UI_STC_DUNGEONENTRYPAGE_LevelSeriouslyUnsuitable	当前等级严重偏低
TextMapUIStcData_TextMapContent_UI_STC_DUNGEONENTRYPAGE_Start	开始挑战
TextMapUIStcData_TextMapContent_UI_DUNGEONENTRY_DAILY_ENTRY_COUNT	本日剩余挑战次数：{0}/{1}
TextMapUIStcData_TextMapContent_UI_DUNGEONENTRY_DAILY_NO_COUNT	本日已无挑战次数：0/{0}
TextMapUIStcData_TextMapContent_UI_DUNGEONENTRY_DAILY_INFINITE_COUNT	无挑战次数限制
TextMapUIStcData_TextMapContent_UI_STC_DungeonRevive_Quit	放弃挑战
TextMapUIStcData_TextMapContent_UI_STC_DungeonRevive_Restart	重新挑战
TextMapUIStcData_TextMapContent_UI_STC_DungeonRevive_LastCheckPoint	从复苏之门继续挑战
TextMapUIStcData_TextMapContent_UI_STC_DungeonRevive_ReviveCount	剩余复活次数
TextMapUIStcData_TextMapContent_UI_STC_DungeonRevive_AutoQuitAfter	{0}秒后自动放弃
TextMapUIStcData_TextMapContent_UI_STC_DungeonSettle_AutoQuitAfter	{0}秒后自动退出
TextMapUIStcData_TextMapContent_UI_STC_World_Revive	复活
TextMapUIStcData_TextMapContent_UI_STC_SlotEquiped	已装备
TextMapUIStcData_TextMapContent_UI_STC_PlayerEnter	玩家{0}进入世界
TextMapUIStcData_TextMapContent_UI_STC_PlayerLeave	玩家{0}离开世界
TextMapUIStcData_TextMapContent_UI_STC_EnterOthersWorld_Title	进入联机
TextMapUIStcData_TextMapContent_UI_STC_EnterOthersWorld_Hint	是否进入该玩家的世界？
TextMapUIStcData_TextMapContent_UI_STC_BackMyWorld_Title	返回
TextMapUIStcData_TextMapContent_UI_STC_BackMyWorld_Hint	是否返回自己的世界？
TextMapUIStcData_TextMapContent_UI_STC_ConfirmKickSquads_Title	回到单机
TextMapUIStcData_TextMapContent_UI_STC_ConfirmKickSquads_Hint	确认断开当前世界所有其他玩家的连接？
TextMapUIStcData_TextMapContent_UI_STC_GonnaKickSquads	稍后将移除所有连入玩家
TextMapUIStcData_TextMapContent_UI_STC_KickedBySquadLeader	世界主人主动断开了连接
TextMapUIStcData_TextMapContent_UI_STC_DungeonFollow_Title	进入地城请求
TextMapUIStcData_TextMapContent_UI_STC_DungeonFollow_Hint	世界主人请求进入战斗地城，\n取消将断开世界连接
TextMapUIStcData_TextMapContent_UI_STC_Intee_DungeonEntry	地下城入口
TextMapUIStcData_TextMapContent_UI_STC_Intee_DungeonExit	退出地下城
TextMapUIStcData_TextMapContent_UI_STC_UseProps_ReviveAvatar	使用道具复活角色
TextMapUIStcData_TextMapContent_Cancel	取消
TextMapUIStcData_TextMapContent_OK	确认
TextMapUIStcData_TextMapContent_Detail	详情
TextMapUIStcData_TextMapContent_UI_STC_AVATAR_IN_TEAM	出战中
TextMapUIStcData_TextMapContent_UI_STC_AVATAR_IN_PREPARING	备战中
TextMapUIStcData_TextMapContent_UI_STC_AVATAR_IN_RECOVERY	恢复中
TextMapUIStcData_TextMapContent_UI_STC_CLICK_TO_USE_SPRING	点击角色头像恢复角色生命值
TextMapUIStcData_TextMapContent_UI_STC_REMAINING_SPRING	恢复力: 
TextMapUIStcData_TextMapContent_UI_STC_SPRING_TITLE	神像的恩泽
TextMapUIStcData_TextMapContent_UI_STC_SPRING_TIME_TO_FULL	会随时间补充。
TextMapUIStcData_TextMapContent_UI_STC_SPRING_NEAR_AUTO_RECOVER	靠近时自动恢复
TextMapUIStcData_TextMapContent_UI_STC_NONE_REVIVE_PROPS	无可用复活道具
TextMapUIStcData_TextMapContent_UI_STC_HOURS_REMIAN	剩余{0}小时
TextMapUIStcData_TextMapContent_UI_STC_AVATAR_LEVEL_INSUFFCIENT_TO_PROMOTION	角色未满级，不能突破
TextMapUIStcData_TextMapContent_UI_STC_AVATAR_GOTO_LEVELUP	前往强化
TextMapUIStcData_TextMapContent_UI_STC_AVATAR_BREAK_LEVEL_MAX	突破等级已达上限
TextMapUIStcData_TextMapContent_UI_WEAPON_GOTO_STARUP	前往突破
TextMapUIStcData_TextMapContent_UI_WEAPON_GOTO_LEVELUP	前往升级
TextMapUIStcData_TextMapContent_UI_EQUIP_PAGE_LEVEL_UP	强化
TextMapUIStcData_TextMapContent_UI_EQUIP_PAGE_STAR_UP	突破
TextMapUIStcData_TextMapContent_UI_EQUIP_PAGE_AWAKEN	精炼
TextMapUIStcData_TextMapContent_UI_EQUIP_PAGE_LEVELUP_BUTTON	强化
TextMapUIStcData_TextMapContent_UI_EQUIP_PAGE_DETAIL_BUTTON	详情
TextMapUIStcData_TextMapContent_UI_EQUIP_PAGE_STARUP_BUTTON	突破
TextMapUIStcData_TextMapContent_UI_EQUIP_PAGE_AWAKEN_BUTTON	精炼
TextMapUIStcData_TextMapContent_UI_WEAPON_LEVELUP_MATERIAL_NEED	需要武器或者精锻用矿才可强化
TextMapUIStcData_TextMapContent_UI_RELIC_LEVELUP_MATERIAL_NEED	需要圣遗物才可强化
TextMapUIStcData_TextMapContent_UI_REPLACE_BUTTON	替换
TextMapUIStcData_TextMapContent_UI_DELETE_BUTTON	删除
TextMapUIStcData_TextMapContent_UI_EQUIP_BUTTON	装备
TextMapUIStcData_TextMapContent_UI_DISCHARGE_BUTTON	卸下
TextMapUIStcData_TextMapContent_UI_PROMOTE_BUTTON	强化
TextMapUIStcData_TextMapContent_UI_WEAPON_STARUP_MATERIAL_NEED	需要同突破等级武器材料才可突破
TextMapUIStcData_TextMapContent_UI_WEAPON_AWAKEN_MATERIAL_NEED	需要同名武器材料才可精炼
TextMapUIStcData_TextMapContent_UI_STC_MATERIAL_USE	使用
TextMapUIStcData_TextMapContent_UI_STC_DOCUMENT_READ	阅读
TextMapUIStcData_TextMapContent_UI_STC_QUEST_TALK_RECORD	对话记录
TextMapUIStcData_TextMapContent_UI_STC_NEW	新
TextMapUIStcData_TextMapContent_UI_CHARACTER_DETAIL	详细信息
TextMapUIStcData_TextMapContent_UI_CHARACTER_CLOSE	关闭
TextMapUIStcData_TextMapContent_UI_STC_TrialLabel	试用
TextMapUIStcData_TextMapContent_UI_STC_TrialTitle	试用角色
TextMapUIStcData_TextMapContent_UI_WEAPON_PROP_CHANGE	武器属性变更
TextMapUIStcData_TextMapContent_UI_RELIC_SUITE_DESC	套装效果
TextMapUIStcData_TextMapContent_UI_RELIC_SUITE_CHANGE	套装属性变更
TextMapUIStcData_TextMapContent_UI_RELIC_CHARACTER_PROP_CHANGE	角色属性变更
TextMapUIStcData_TextMapContent_UI_FAST_ADD_BUTTON	快捷放入
TextMapUIStcData_TextMapContent_UI_FAST_ADD_OPTION_1	1星素材
TextMapUIStcData_TextMapContent_UI_FAST_ADD_OPTION_2	2星及以下素材
TextMapUIStcData_TextMapContent_UI_FAST_ADD_OPTION_3	3星及以下素材
TextMapUIStcData_TextMapContent_UI_RELIC_NO_SUITE	当前暂无套装效果
TextMapUIStcData_TextMapContent_UI_STC_QUEST_NAVIGATION	寻路指引
TextMapUIStcData_TextMapContent_UI_TALENT_REMAINING_POINT	可使用的星尘/星辉数
TextMapUIStcData_TextMapContent_UI_TALENT_UNLOCK	激活
TextMapUIStcData_TextMapContent_UI_TALENT_LEVEL_UP	升级
TextMapUIStcData_TextMapContent_UI_TALENT_NEED	{0}需要
TextMapUIStcData_TextMapContent_UI_STC_MAP_TITLE	地图
TextMapUIStcData_TextMapContent_UI_STC_MAP_TAG	地图标记
TextMapUIStcData_TextMapContent_UI_STC_MAP_TAG_NUM	<color=#FF5E41FF>{0}</color>/{1}
TextMapUIStcData_TextMapContent_UI_STC_MAP_TAG_IS_MAX	标记已达上限
TextMapUIStcData_TextMapContent_UI_STC_AVATAR_LIST_BUTTON	角色列表
TextMapUIStcData_TextMapContent_INFO_CONFIRM_TO_BUY	确认花费{0}购买{1}？
TextMapUIStcData_TextMapContent_INFO_CONFIRM_TO_GO	确认传送到此处？
TextMapUIStcData_TextMapContent_INFO_BUY_FAIL_COST_UNSATISFIED	所需材料不够
TextMapUIStcData_TextMapContent_INFO_BUY_FAIL_NO_LEFT_ITEM	超出可购买数量
TextMapUIStcData_TextMapContent_UI_STC_MATERIAL_CURR_NUM	
TextMapUIStcData_TextMapContent_UI_WEAPON_STARUP_PROP_CHANGE	属性变化
TextMapUIStcData_TextMapContent_UI_WEAPON_STARUP_NEED	武器突破素材
TextMapUIStcData_TextMapContent_UI_WEAPON_AWAKEN_NEED	武器精炼材料
TextMapUIStcData_TextMapContent_UI_WEAPON_AFFIX_DESC	武器词缀
TextMapUIStcData_TextMapContent_UI_WEAPON_AFFIX_UPGRADE_SELECT	选择升级词缀
TextMapUIStcData_TextMapContent_UI_RELIC_AFFIX_PROP	当前追加属性
TextMapUIStcData_TextMapContent_UI_RELIC_STARUP_NEED	圣遗物突破素材
TextMapUIStcData_TextMapContent_UI_EQUIP_LEVELUP_NEED	装备强化消耗
TextMapUIStcData_TextMapContent_UI_EQUIP_FAST_EQUIP	快速装备
TextMapUIStcData_TextMapContent_UI_STC_GODDESS_CONTRIBUTE	供奉
TextMapUIStcData_TextMapContent_UI_STC_GODDESS_CONTRUBUTE_ALL	全部供奉
TextMapUIStcData_TextMapContent_UI_STC_GODDESS_ENERGY_PREFIX	元素能量: 
TextMapUIStcData_TextMapContent_UI_STC_GODDESS_LEVEL_TITLE	供奉神像
TextMapUIStcData_TextMapContent_UI_STC_GODDESS_NEXT_LEVEL_UNLOCK	神像的馈赠
TextMapUIStcData_TextMapContent_UI_STC_GODDESS_NEED_MATERIALS	所需风神瞳({0})
TextMapUIStcData_TextMapContent_UI_STC_GODDESS_MATERIAL_CURR_COUNT	当前持有
TextMapUIStcData_TextMapContent_UI_STC_GODDESS_LEVEL_MAX_HINT	你的努力得到了神像的认可。
TextMapUIStcData_TextMapContent_UI_GODDESS_AREA_ELEMENT_ENHANCE	区域内的元素流动更加通畅了
TextMapUIStcData_TextMapContent_UI_SKILL_PREVIEW	技能预览
TextMapUIStcData_TextMapContent_UI_RELIC_SUITE_NO_CHANGE	无变化
TextMapUIStcData_TextMapContent_UI_STC_GODDESS_UNLOCK_IMPROVE_STAMINA	增加体力{0}点
TextMapUIStcData_TextMapContent_UI_BUTTON_CANCEL	取消
TextMapUIStcData_TextMapContent_UI_BUTTON_CHANGE	更换
TextMapUIStcData_TextMapContent_UI_BUTTON_ADD	加入
TextMapUIStcData_TextMapContent_UI_BUTTON_DELETE	换下
TextMapUIStcData_TextMapContent_UI_TEAM_TITLE	队伍配置
TextMapUIStcData_TextMapContent_UI_TEAM_SELECT_AVATAR	请选择编入队伍的角色
TextMapUIStcData_TextMapContent_UI_QUEST_RECOMMEND_LEVEL	推荐等级: Lv.{0}
TextMapUIStcData_TextMapContent_UI_PLAYER_PROFILE_SETTING	设置
TextMapUIStcData_TextMapContent_UI_PLAYER_PROFILE_MAIL	邮件
TextMapUIStcData_TextMapContent_UI_PLAYER_PROFILE_PLAYERLV	冒险等阶
TextMapUIStcData_TextMapContent_UI_PLAYER_PROFILE_PLAYEREXP	冒险阅历
TextMapUIStcData_TextMapContent_UI_PLAYER_PROFILE_UID	UID
TextMapUIStcData_TextMapContent_UI_SETTING_PAGE_TITLE	设置
TextMapUIStcData_TextMapContent_UI_SETTING_PAGE_CONTROL_CATEGORY	控制
TextMapUIStcData_TextMapContent_UI_SETTING_PAGE_GRAPHIC_CATEGORY	图像
TextMapUIStcData_TextMapContent_UI_SETTING_PAGE_SOUND_CATEGORY	声音
TextMapUIStcData_TextMapContent_UI_SETTING_PAGE_MESSAGE_CATEGORY	消息
TextMapUIStcData_TextMapContent_UI_SETTING_PAGE_LANGUAGE_CATEGORY	语言
TextMapUIStcData_TextMapContent_UI_SETTING_PAGE_OTHER_CATEGORY	其他
TextMapUIStcData_TextMapContent_UI_SETTING_PAGE_RESET_DEFAULT	重置为默认
TextMapUIStcData_TextMapContent_UI_SETTING_PAGE_SAVE	保存设置
TextMapUIStcData_TextMapContent_UI_SETTING_MOUSE_SENSITIVITY	鼠标灵敏度
TextMapUIStcData_TextMapContent_UI_SETTING_UI_RESOLUTION	分辨率
TextMapUIStcData_TextMapContent_UI_SETTING_GRAPHICS_QUALITY	图像质量
TextMapUIStcData_TextMapContent_UI_SETTING_MOUSE_TITLE	鼠标
TextMapUIStcData_TextMapContent_UI_SETTING_KEY_TITLE	按键设定
TextMapUIStcData_TextMapContent_UI_SETTING_UI_TITLE	交互
TextMapUIStcData_TextMapContent_UI_SETTING_GRAPHICS_TITLE	图像
TextMapUIStcData_TextMapContent_UI_SETTING_LANGUAGE_TITLE	语言
TextMapUIStcData_TextMapContent_UI_SETTING_GAME_LANGUAGE	游戏语言
TextMapUIStcData_TextMapContent_UI_SETTING_GRAPHICS_QUALITY_2_0	中
TextMapUIStcData_TextMapContent_UI_SETTING_GRAPHICS_QUALITY_2_1	高
TextMapUIStcData_TextMapContent_UI_SETTING_GRAPHICS_QUALITY_3_0	低
TextMapUIStcData_TextMapContent_UI_SETTING_GRAPHICS_QUALITY_3_1	中
TextMapUIStcData_TextMapContent_UI_SETTING_GRAPHICS_QUALITY_3_2	高
TextMapUIStcData_TextMapContent_UI_SETTING_DISPLAY_MODE	显示模式
TextMapUIStcData_TextMapContent_UI_SETTING_FULL_SCREEN_DISPLAY	独占全屏
TextMapUIStcData_TextMapContent_UI_SETTING_FRAMELESS_WINDOW_DISPLAY	窗口
TextMapUIStcData_TextMapContent_UI_SETTING_WINDOW_RESOLUTION	窗口分辨率
TextMapUIStcData_TextMapContent_UI_AVATAR_INFO_PROP_BASICS	基础属性
TextMapUIStcData_TextMapContent_UI_AVATAR_INFO_PROP_ADVANCED	进阶属性
TextMapUIStcData_TextMapContent_UI_AVATAR_INFO_PROP_ELEMENT	元素属性
TextMapUIStcData_TextMapContent_UI_FINISH_MAIN_QUEST_REWARD	完成系列任务可获得
TextMapUIStcData_TextMapContent_UI_INFO_FEEDBACK	反馈
TextMapUIStcData_TextMapContent_UI_HUD_RESOLUTION	UI分辨率
TextMapUIStcData_TextMapContent_UI_SCENE_ENTRY_EXIT_KNIGHT	离开骑士团
TextMapUIStcData_TextMapContent_UI_SCENE_ENTRY_EXIT_CHURCH	离开教堂
TextMapUIStcData_TextMapContent_UI_SCENE_ENTRY_ENTER_KNIGHT	进入骑士团
TextMapUIStcData_TextMapContent_UI_SCENE_ENTRY_ENTER_CHURCH	进入教堂
TextMapUIStcData_TextMapContent_UI_SCENE_ENTRY_ENTER_BASEMENT	进入地下室
TextMapUIStcData_TextMapContent_UI_SCENE_ENTRY_ENTER_ANGELSHARE	进入酒馆
TextMapUIStcData_TextMapContent_UI_SCENE_ENTRY_EXIT_ANGELSHARE	离开酒馆
TextMapUIStcData_TextMapContent_UI_DUNGEON_MISSION_FAIL	挑战失败
TextMapUIStcData_TextMapContent_UI_DUNGEON_MISSION_COMPLETE	挑战达成
TextMapUIStcData_TextMapContent_UI_DUNGEON_EXIT	离开
TextMapUIStcData_TextMapContent_UI_DUNGEON_ENTRY_1	北风之狼的庙宇
TextMapUIStcData_TextMapContent_UI_DUNGEON_ENTRY_20	西风之鹰的庙宇
TextMapUIStcData_TextMapContent_UI_DUNGEON_ENTRY_22	南风之狮的庙宇
TextMapUIStcData_TextMapContent_UI_DUNGEON_ENTRY_24	深入风龙废墟
TextMapUIStcData_TextMapContent_UI_DUNGEON_ENTRY_26	鹰之门
TextMapUIStcData_TextMapContent_UI_DUNGEON_ENTRY_27	海蚀孤塔
TextMapUIStcData_TextMapContent_UI_DUNGEON_ENTRY_29	忘却之峡
TextMapUIStcData_TextMapContent_UI_DUNGEON_ENTRY_31	静谧殿堂
TextMapUIStcData_TextMapContent_UI_DUNGEON_ENTRY_35	仲夏庭园
TextMapUIStcData_TextMapContent_UI_DUNGEON_ENTRY_37	塞西莉亚苗圃
TextMapUIStcData_TextMapContent_UI_DUNGEON_ENTRY_39	失落的阿卡狄亚
TextMapUIStcData_TextMapContent_UI_WORLD_LIST	世界列表
TextMapUIStcData_TextMapContent_UI_KICK_ALL_OUT	踢出
TextMapUIStcData_TextMapContent_UI_ALLOW_TO_JOIN	允许加入
TextMapUIStcData_TextMapContent_UI_COMMON_ITEM_NEED	需要
TextMapUIStcData_TextMapContent_UI_REPAIR_SKYHARP_PAGE_TITLE	修复天空之琴
TextMapUIStcData_TextMapContent_UI_REPAIR_SKYHARP_PAGE_REPAIR_BUTTON	修复
TextMapUIStcData_TextMapContent_UI_REPAIR_SKYHARP_PAGE_INREPAIR_BUTTON	修复中
TextMapUIStcData_TextMapContent_UI_REPAIR_SKYHARP_PAGE_COMPLETE_BUTTON	完成
TextMapUIStcData_TextMapContent_UI_COOKING_NOTHING_TIP_TITLE	没有任何道具
TextMapUIStcData_TextMapContent_UI_COOKING_NOTHING_TIP_DESC	这里空空如也
TextMapUIStcData_TextMapContent_UI_COOKING_MAKE_BUTTON	制作
TextMapUIStcData_TextMapContent_UI_COOKING_FETCH_BUTTON	获取
TextMapUIStcData_TextMapContent_UI_COOKING_AVATAR_SELECT_TITLE	角色选择
TextMapUIStcData_TextMapContent_UI_COOKING_AVATAR_SELECT_OK_BUTTON	确认
TextMapUIStcData_TextMapContent_UI_COOKING_QTE_TITLE	烹饪
TextMapUIStcData_TextMapContent_UI_COOKING_QTE_START_BUTTON	开始
TextMapUIStcData_TextMapContent_UI_COOKING_QTE_END_BUTTON	结束
TextMapUIStcData_TextMapContent_UI_COOKING_QTE_AVATAR_BONUS_TITLE	角色加成
TextMapUIStcData_TextMapContent_UI_COOKING_QTE_ITEM_GOT_CLOSE_BUTTON	确认
TextMapUIStcData_TextMapContent_UI_COOKING_QTE_ITEM_GOT_TIP	获得食物
TextMapUIStcData_TextMapContent_UI_COOKING_QTE_AUTO_MAKE_BUTTON	自动烹饪
TextMapUIStcData_TextMapContent_UI_ITEM_GET_DIALOG_TITLE	获得
TextMapUIStcData_TextMapContent_UI_INSTRUCTION_DISCOVERY	新图鉴条目
TextMapUIStcData_TextMapContent_UI_MAIL_TITLE	邮箱
TextMapUIStcData_TextMapContent_UI_MAIL_GET_BUTTON	领取
TextMapUIStcData_TextMapContent_UI_MAIL_GET_ALL_BUTTON	全部领取
TextMapUIStcData_TextMapContent_UI_MAIL_DELETE_BUTTON	删除
TextMapUIStcData_TextMapContent_UI_MAIL_HAS_GET_TIP	已领取
TextMapUIStcData_TextMapContent_UI_MAIL_NO_MAIL_TIP_TITLE	没有新邮件
TextMapUIStcData_TextMapContent_UI_MAIL_NO_MAIL_TIP_DESC	去其它地方看看吧
TextMapUIStcData_TextMapContent_UI_MAIL_NUM_LABEL	邮件数
TextMapUIStcData_TextMapContent_UI_SKIP_BUTTON	跳过
TextMapUIStcData_TextMapContent_UI_AVATAR_SITDOWN	坐下
TextMapUIStcData_TextMapContent_UI_NAME_TITLE	陨星内部刻写着你的名字
TextMapUIStcData_TextMapContent_UI_NAME_DESCRIPTION	我有种感觉，你的名字，一定能传达到大地和星辰之外…
TextMapUIStcData_TextMapContent_UI_NAME_LENGTH	字符长度1-8
TextMapUIStcData_TextMapContent_UI_SEALBATTLE_PROGRESS_TITLE	导光仪式进度
TextMapUIStcData_TextMapContent_BAN_TRANSPORT	任务紧急，暂时无法传送！
TextMapUIStcData_TextMapContent_BAN_GOTO_SCENE	任务紧急，暂时无法前往其他场景！
TextMapUIStcData_TextMapContent_BAN_NPC_INTERACTION	任务紧急，请先完成当前挑战！
TextMapUIStcData_TextMapContent_BAN_GOTO_MULTIPLAYER	任务紧急，请先完成当前挑战！
TextMapUIStcData_TextMapContent_UI_BAN_MAP_TIPS	室内暂时无法查看详情地图
TextMapUIStcData_TextMapContent_UI_ENTER_SCENE_FAIL	登录失败
TextMapUIStcData_TextMapContent_UI_DATAVERSION_CHANGE	数值版本发生变化
TextMapUIStcData_TextMapContent_UI_DATAVERSION_CHANGE_INFO	版本从{0}变到{1}
TextMapUIStcData_TextMapContent_UI_RETCODE_TITLE	系统提示
TextMapUIStcData_TextMapContent_UI_MAP_JUMP_POINT	是否跳转{0}？
TextMapUIStcData_TextMapContent_UI_STC_MAIN_PLAYER_LV	冒险等阶 {0}
TextMapUIStcData_TextMapContent_UI_BULLETIN_QTE_TITLE1	猎鹿人今日推荐
TextMapUIStcData_TextMapContent_UI_BULLETIN_QTE_TITLE2	晨曦酒庄招募书
TextMapUIStcData_TextMapContent_UI_CLOCK_PAGE_CURRENT_TIME	当前时间
TextMapUIStcData_TextMapContent_UI_CLOCK_PAGE_TO_TIME	调整到
TextMapUIStcData_TextMapContent_UI_CHAPTER_COMPLETE_DIALOG_CONTINUE	未完待续
TextMapUIStcData_TextMapContent_UI_CHAPTER_BEGIN_DIALOG_ENABLED	已开启
TextMapUIStcData_TextMapContent_UI_CHAPTER_BEGIN_DIALOG_TIP	详情请查看任务面板
TextMapUIStcData_TextMapContent_UI_STC_MAIN_RETURN_TO_QUEST	返回任务点
TextMapUIStcData_TextMapContent_UI_FRESHMAN_GUIDE_TITLE	新手提示
TextMapUIStcData_TextMapContent_UI_FRESHMAN_GUIDE_INFO	是否跳过新手引导？
TextMapUIStcData_TextMapContent_UI_GUIDE_CAMERA_ROTATE	划动屏幕以转动视角
TextMapUIStcData_TextMapContent_UI_GUIDE_CAMERA_ROTATE_PC	移动鼠标以转动视角
TextMapUIStcData_TextMapContent_UI_GUIDE_CAMERA_SCALE	两指缩放以调整视角远近
TextMapUIStcData_TextMapContent_UI_GUIDE_CAMERA_SCALE_PC	滚动鼠标滚轮调整视角远近
TextMapUIStcData_TextMapContent_UI_GUIDE_INFO_MOVE	拖动摇杆移动
TextMapUIStcData_TextMapContent_UI_GUIDE_INFO_MOVE_PC	按下WASD键移动
TextMapUIStcData_TextMapContent_UI_GUIDE_INFO_MOVEFORWARD	向前拖动摇杆移动
TextMapUIStcData_TextMapContent_UI_GUIDE_INFO_MOVEFORWARD_PC	按下W键向前移动
TextMapUIStcData_TextMapContent_UI_GUIDE_INFO_SPRINT	点击按钮冲刺，起步瞬间有闪避效果
TextMapUIStcData_TextMapContent_UI_GUIDE_INFO_SPRINT_PC	点击鼠标右键或Shift键冲刺，起步瞬间有闪避效果
TextMapUIStcData_TextMapContent_UI_GUIDE_INFO_JUMP	点击按钮跳跃
TextMapUIStcData_TextMapContent_UI_GUIDE_INFO_JUMP_PC	按下空格键跳跃
TextMapUIStcData_TextMapContent_UI_GUIDE_INFO_ATTACK	点击按钮攻击
TextMapUIStcData_TextMapContent_UI_GUIDE_INFO_ATTACK_PC	点击鼠标左键攻击
TextMapUIStcData_TextMapContent_UI_GUIDE_INFO_LONGPRESS_TO_AIM	长按安柏的攻击按钮，也可以进入瞄准模式
TextMapUIStcData_TextMapContent_UI_GUIDE_INFO_LONGPRESS_TO_AIM_PC	使用安柏时长按鼠标左键，也可以进入瞄准模式
TextMapUIStcData_TextMapContent_UI_GUIDE_INFO_FLY	点击按钮滑翔
TextMapUIStcData_TextMapContent_UI_GUIDE_INFO_FLY_PC	按下空格键滑翔
TextMapUIStcData_TextMapContent_UI_GUIDE_INFO_FLYINWIND	在风场内点击跳跃键两次，可以乘风起飞
TextMapUIStcData_TextMapContent_UI_GUIDE_INFO_FLYINWIND_PC	在风场内点击空格键两次，可以乘风起飞
TextMapUIStcData_TextMapContent_UI_GUIDE_INFO_FLYWARNING	危险动作，请勿模仿
TextMapUIStcData_TextMapContent_UI_GUIDE_INFO_ENTER_AIMING	点击按钮进入瞄准模式
TextMapUIStcData_TextMapContent_UI_GUIDE_INFO_ENTER_AIMING_PC	按下R键进入/退出瞄准模式
TextMapUIStcData_TextMapContent_UI_GUIDE_INFO_EXIT_AIMING	再次点击按钮退出瞄准模式
TextMapUIStcData_TextMapContent_UI_GUIDE_INFO_EXIT_AIMING_PC	再次按下R键退出瞄准模式
TextMapUIStcData_TextMapContent_UI_GUIDE_INFO_INTERACTION	靠近传送锚点后，点击交互按钮解锁
TextMapUIStcData_TextMapContent_UI_GUIDE_INFO_INTERACTION_PC	靠近传送锚点后，按下F键交互解锁
TextMapUIStcData_TextMapContent_UI_GUIDE_INFO_QUEST_ELEMENTVISION	长按鼠标中键进入元素视野
TextMapUIStcData_TextMapContent_UI_GUIDE_INFO_QUEST_CHANGETIME	按下ESC开启派蒙界面，可在“时间”中改变游戏时间
TextMapUIStcData_TextMapContent_UI_COUNTDOWN_GO	开始！
TextMapUIStcData_TextMapContent_UI_COUNTDOWN_CLOCK_OVER	时间结束
TextMapUIStcData_TextMapContent_UI_NO_QUEST_TITLE	无进行中任务
TextMapUIStcData_TextMapContent_UI_NO_QUEST_SUGGESTION	可以使用小地图探索周边区域
TextMapUIStcData_TextMapContent_UI_COUNT_SELECT_TITLE	选择数量
TextMapUIStcData_TextMapContent_UI_GUIDE_SWITCH_CHARACTER	弓箭手安柏适合处理远处的目标，点击头像让安柏出场
TextMapUIStcData_TextMapContent_UI_GUIDE_SWITCH_CHARACTER_PC	弓箭手安柏适合处理远处的目标，按下数字键1让安柏出场
TextMapUIStcData_TextMapContent_UI_GUIDE_AIMING_CAMERA_ROTATE	划动屏幕以移动准星，试试攻击空中的风史莱姆吧
TextMapUIStcData_TextMapContent_UI_GUIDE_AIMING_CAMERA_ROTATE_PC	移动鼠标以调整准星位置，点击鼠标左键射箭，试试攻击空中的风史莱姆吧
TextMapUIStcData_TextMapContent_UI_GUIDE_AIMING_SHOOT	点击攻击按钮射箭
TextMapUIStcData_TextMapContent_UI_GUIDE_INFO_RADAR	按照小地图指引前往目的地，点击可以打开地图界面
TextMapUIStcData_TextMapContent_UI_GUIDE_INFO_RADAR_PC	按照小地图指引前往目的地，按下M可以打开地图界面
TextMapUIStcData_TextMapContent_UI_GUIDE_INFO_ELEMENT_SKILL	点击释放元素战技
TextMapUIStcData_TextMapContent_UI_GUIDE_INFO_ELEMENT_SKILL_PC	点击E释放元素战技
TextMapUIStcData_TextMapContent_UI_GUIDE_INFO_ELEMENT_SKILL_CD	冷却时间结束后，才能再次释放
TextMapUIStcData_TextMapContent_UI_GUIDE_INFO_ELEMENT_SKILL_HOLD	长按蓄力威力更大
TextMapUIStcData_TextMapContent_UI_GUIDE_INFO_ELEMENT_SKILL_HOLD_PC	长按E蓄力威力更大
TextMapUIStcData_TextMapContent_UI_GUIDE_INFO_ELEMENT_SKILL_BURST	点击释放元素爆发
TextMapUIStcData_TextMapContent_UI_GUIDE_INFO_ELEMENT_SKILL_BURST_PC	点击Q释放元素爆发
TextMapUIStcData_TextMapContent_UI_GUIDE_INFO_QUEST_BTN	点击打开任务面板
TextMapUIStcData_TextMapContent_UI_GUIDE_INFO_QUEST_TRACKER	点击追踪当前任务
TextMapUIStcData_TextMapContent_UI_GUIDE_INFO_VIEW_PAIMON	点击按钮可以打开派蒙界面
TextMapUIStcData_TextMapContent_UI_GUIDE_INFO_VIEW_PAIMON_PC	按下Esc打开派蒙界面，可以在“设置-控制”中查看所有按键键位
TextMapUIStcData_TextMapContent_UI_GUIDE_INFO_VIEW_HELP	点击按钮获取更多游戏提示
TextMapUIStcData_TextMapContent_UI_GUIDE_INFO_VIEW_HELP_PC	按下F1获取更多游戏提示
TextMapUIStcData_TextMapContent_UI_GUIDE_INFO_OPEN_CHARACTERPAGE_PC	按下K键打开角色界面
TextMapUIStcData_TextMapContent_UI_MAP_GODDESS_LEVEL_TITLE	七天神像
TextMapUIStcData_TextMapContent_UI_SWITCH_TO_AVATAR1_KEY	1
TextMapUIStcData_TextMapContent_UI_SWITCH_TO_AVATAR2_KEY	2
TextMapUIStcData_TextMapContent_UI_SWITCH_TO_AVATAR3_KEY	3
TextMapUIStcData_TextMapContent_UI_MAP_AREA1_TITLE_1	望风角
TextMapUIStcData_TextMapContent_UI_MAP_AREA1_TITLE_2	望风山地
TextMapUIStcData_TextMapContent_UI_MAP_AREA1_TITLE_3	星落湖
TextMapUIStcData_TextMapContent_UI_MAP_AREA1_TITLE_4	低语森林
TextMapUIStcData_TextMapContent_UI_MAP_AREA1_TITLE_5	摘星崖
TextMapUIStcData_TextMapContent_UI_MAP_AREA1_TITLE_6	千风神殿
TextMapUIStcData_TextMapContent_UI_MAP_AREA1_TITLE_7	蒙德城
TextMapUIStcData_TextMapContent_UI_MAP_AREA1_TITLE_8	果酒湖
TextMapUIStcData_TextMapContent_UI_MAP_AREA2_TITLE_1	风起地
TextMapUIStcData_TextMapContent_UI_MAP_AREA2_TITLE_2	鹰翔海滩
TextMapUIStcData_TextMapContent_UI_MAP_AREA2_TITLE_3	达达乌帕谷
TextMapUIStcData_TextMapContent_UI_MAP_AREA2_TITLE_4	誓言岬
TextMapUIStcData_TextMapContent_UI_MAP_AREA3_TITLE_1	清泉镇
TextMapUIStcData_TextMapContent_UI_MAP_AREA3_TITLE_2	龙脊雪山
TextMapUIStcData_TextMapContent_UI_MAP_AREA3_TITLE_3	晨曦酒庄
TextMapUIStcData_TextMapContent_UI_MAP_AREA3_TITLE_4	奔狼领
TextMapUIStcData_TextMapContent_UI_MAP_AREA4_TITLE_1	风龙遗迹
TextMapUIStcData_TextMapContent_UI_MAP_AREA4_TITLE_2	明冠峡